Team_Cumulative_ID,Team_ID,Player_ID,GP,Min,SST,SSTexPts ,Pts , Ast ,Turnover,Ast_To_Ratio,Stl,  StlPos ,  Blk,  TtlReb ,  OffReb ,  DefReb,Field_Goals_Attempt,Field_Goals_Made,Field_Goals_Missed,Field_Goal_Percentage,Adjusted_Field_Goal_Percentage,Two_Field_Goals_Attempt,Two_Field_Goals_Made,Two_Field_Goals_Missed,Two_Field_Goal_Percentage,Three_Field_Goals_Attempt,Three_Field_Goals_Made,Three_Field_Goals_Missed,Three_Field_Goal_Percentage,Free_Throw_Attempts,Free_Throw_Made,Free_Throw_Missed,Free_Throw_Percentage,And_One,Personal_Fouls_Taken,Total_Personal_Fouls_Commited
369,21,340,25,805,0.9,0.24,371,87,63,1.38,29,35,1,78,5,73,292,131,161,0.449,0.582,115,53,62,0.461,177,78,99,0.441,35,31,4,0.886,1,37,65
370,21,331,4,16,0.2,-0.13,5,1,5,0.2,2,2,0,2,0,2,5,2,3,0.4,0.5,2,1,1,0.5,3,1,2,0.333,0,0,0,-,0,0,2
371,21,334,25,798,0.71,0.25,285,73,37,1.97,19,23,6,68,10,58,252,105,147,0.417,0.532,89,47,42,0.528,163,58,105,0.356,20,17,3,0.85,2,13,44
372,21,328,14,395,0.58,0.36,64,65,33,1.97,9,14,0,54,7,47,64,22,42,0.344,0.414,40,13,27,0.325,24,9,15,0.375,24,11,13,0.458,3,24,31
373,21,330,25,580,0.82,0.32,149,33,28,1.18,22,14,3,104,22,82,93,52,41,0.559,0.608,75,43,32,0.573,18,9,9,0.5,54,36,18,0.667,7,37,49
374,21,333,12,129,0.76,0.43,30,11,6,1.83,6,1,1,24,8,16,32,12,20,0.375,0.391,23,11,12,0.478,9,1,8,0.111,8,5,3,0.625,2,8,11
375,21,327,3,16,0.73,-0.13,9,0,1,0,0,1,0,0,0,0,6,4,2,0.667,0.667,5,4,1,0.8,1,0,1,0,3,1,2,0.333,0,1,0
376,21,335,17,444,0.53,0.27,86,31,32,0.97,11,13,0,80,18,62,80,36,44,0.45,0.475,60,32,28,0.533,20,4,16,0.2,19,10,9,0.526,1,20,35
377,21,326,6,26,0.06,0.19,2,0,0,-,0,0,0,5,0,5,9,1,8,0.111,0.111,3,1,2,0.333,6,0,6,0,0,0,0,-,0,2,5
378,21,336,25,566,1.38,0.55,283,13,37,0.35,13,17,37,190,69,121,223,118,105,0.529,0.529,221,118,103,0.534,2,0,2,0,70,47,23,0.671,3,55,81
379,21,338,23,362,0.44,0.2,51,28,20,1.4,8,9,0,37,2,35,50,19,31,0.38,0.38,40,19,21,0.475,10,0,10,0,20,13,7,0.65,3,21,27
380,21,332,6,16,1.29,1,3,3,0,-,3,0,0,3,1,2,1,1,0,1,1.5,0,0,0,-,1,1,0,1,0,0,0,-,0,0,2
381,21,341,1,2,0,0,0,0,1,0,0,0,0,1,1,0,0,0,0,-,-,0,0,0,-,0,0,0,-,0,0,0,-,0,0,2
382,21,342,16,151,0.65,0.27,35,3,9,0.33,2,3,3,33,10,23,22,16,6,0.727,0.727,22,16,6,0.727,0,0,0,-,4,3,1,0.75,0,3,15
383,21,339,5,15,0.29,0,4,0,4,0,0,2,0,5,3,2,4,2,2,0.5,0.5,4,2,2,0.5,0,0,0,-,0,0,0,-,0,0,2
384,21,337,25,664,1.91,0.34,517,37,52,0.71,13,24,17,158,37,121,378,187,191,0.495,0.495,376,187,189,0.497,2,0,2,0,184,143,41,0.777,14,138,29
385,21,329,18,100,0.46,0.32,18,3,7,0.43,4,2,6,16,4,12,26,8,18,0.308,0.308,24,8,16,0.333,2,0,2,0,7,2,5,0.286,0,4,14
386,22,346,28,752,0.83,0.24,287,47,48,0.98,24,22,8,87,30,57,226,119,107,0.526,0.558,189,105,84,0.556,37,14,23,0.378,51,35,16,0.686,11,38,60
388,22,348,32,673,0.6,0.27,137,26,32,0.81,21,14,5,112,31,81,119,48,71,0.403,0.471,71,32,39,0.451,48,16,32,0.333,34,25,9,0.735,0,26,66
390,22,351,32,685,0.81,0.26,184,17,58,0.29,21,21,7,150,57,93,154,61,93,0.396,0.396,153,61,92,0.399,1,0,1,0,89,62,27,0.697,9,65,105
391,22,350,32,820,0.68,0.3,189,59,32,1.84,41,16,3,88,13,75,149,67,82,0.45,0.52,96,46,50,0.479,53,21,32,0.396,54,34,20,0.63,3,42,44
392,22,347,32,991,1.29,0.18,659,54,66,0.82,28,29,5,122,13,109,516,243,273,0.471,0.531,333,181,152,0.544,183,62,121,0.339,145,111,34,0.766,15,120,52
393,22,353,32,531,0.7,0.31,130,18,32,0.56,17,15,10,102,36,66,116,48,68,0.414,0.448,83,40,43,0.482,33,8,25,0.242,43,26,17,0.605,1,28,70
394,22,343,30,450,0.71,0.26,119,21,28,0.75,20,8,3,63,23,40,95,45,50,0.474,0.51,73,38,35,0.52,22,7,15,0.318,33,22,11,0.667,3,22,39
395,22,349,5,13,0.75,0.15,6,1,1,1,0,1,0,2,0,2,4,2,2,0.5,0.75,0,0,0,-,4,2,2,0.5,0,0,0,-,0,0,2
396,22,355,24,210,0.63,0.26,50,15,5,3,4,1,2,17,5,12,38,17,21,0.447,0.579,9,7,2,0.778,29,10,19,0.345,8,6,2,0.75,0,4,21
398,22,344,12,65,0.72,0.37,16,3,3,1,0,2,4,10,6,4,14,7,7,0.5,0.5,14,7,7,0.5,0,0,0,-,4,2,2,0.5,0,3,11
399,22,354,27,184,0.72,0.28,50,3,10,0.3,7,3,3,35,11,24,34,22,12,0.647,0.647,33,22,11,0.667,1,0,1,0,12,6,6,0.5,1,12,30
400,22,352,32,923,1.21,0.27,456,23,41,0.56,28,17,7,173,42,131,367,157,210,0.428,0.463,277,131,146,0.473,90,26,64,0.289,138,116,22,0.841,15,112,84
401,22,345,9,17,0.96,0,7,1,3,0.33,1,3,0,2,0,2,2,2,0,1,1.25,1,1,0,1,1,1,0,1,3,2,1,0.667,1,2,1
402,23,363,8,43,0.31,0.21,5,3,1,3,2,1,0,1,0,1,9,2,7,0.222,0.222,4,2,2,0.5,5,0,5,0,2,1,1,0.5,0,1,2
403,23,366,25,568,0.79,0.2,176,21,17,1.24,22,3,4,42,10,32,99,54,45,0.546,0.717,32,20,12,0.625,67,34,33,0.507,38,34,4,0.895,3,28,71
404,23,370,24,355,0.7,0.16,124,10,10,1,7,5,0,38,5,33,90,42,48,0.467,0.611,34,16,18,0.471,56,26,30,0.464,17,14,3,0.824,1,14,34
405,23,368,22,238,0.7,0.2,70,18,21,0.86,11,10,2,23,4,19,49,26,23,0.531,0.612,27,18,9,0.667,22,8,14,0.364,11,10,1,0.909,1,10,16
406,23,358,6,181,0.75,0.18,60,11,16,0.69,6,9,0,26,4,22,60,20,40,0.333,0.367,32,16,16,0.5,28,4,24,0.143,23,16,7,0.696,2,18,8
407,23,365,14,51,0.27,0.14,6,3,2,1.5,0,0,0,4,1,3,8,2,6,0.25,0.312,3,1,2,0.333,5,1,4,0.2,2,1,1,0.5,0,1,1
408,23,356,23,152,0.86,0.16,47,4,11,0.36,3,4,1,27,4,23,29,15,14,0.517,0.517,28,15,13,0.536,1,0,1,0,27,17,10,0.63,2,16,15
409,23,369,25,660,0.81,0.23,270,24,21,1.14,12,12,3,92,23,69,237,92,145,0.388,0.508,79,35,44,0.443,158,57,101,0.361,36,29,7,0.806,5,25,35
410,23,361,25,717,1.14,0.39,302,111,87,1.28,28,40,5,135,32,103,238,116,122,0.487,0.502,212,109,103,0.514,26,7,19,0.269,89,63,26,0.708,7,86,68
411,23,360,16,66,0.38,0.15,8,1,4,0.25,3,2,0,10,0,10,6,2,4,0.333,0.5,0,0,0,-,6,2,4,0.333,2,2,0,1,0,1,7
412,23,362,9,49,0.57,0.27,10,1,1,1,0,0,0,10,3,7,11,3,8,0.273,0.364,4,1,3,0.25,7,2,5,0.286,2,2,0,1,0,1,2
413,23,357,20,216,0.97,0.43,63,33,24,1.38,11,7,4,31,14,17,39,26,13,0.667,0.667,39,26,13,0.667,0,0,0,-,16,11,5,0.688,1,13,35
415,23,359,25,342,1.39,0.39,152,15,13,1.15,17,8,0,76,21,55,93,51,42,0.548,0.548,93,51,42,0.548,0,0,0,-,66,50,16,0.758,5,39,22
416,23,367,19,309,0.78,0.2,122,16,26,0.62,9,13,2,50,11,39,101,52,49,0.515,0.525,91,50,41,0.55,10,2,8,0.2,36,16,20,0.444,2,30,38
420,23,371,5,16,0.13,-0.19,3,1,3,0.33,0,0,0,1,0,1,3,1,2,0.333,0.333,3,1,2,0.333,0,0,0,-,2,1,1,0.5,0,1,5
421,23,364,25,527,0.65,0.25,122,17,18,0.94,13,3,1,80,24,56,90,43,47,0.478,0.539,63,32,31,0.508,27,11,16,0.407,44,25,19,0.568,5,39,59
423,23,372,25,502,1.12,0.21,244,24,46,0.52,13,13,15,75,20,55,184,91,93,0.495,0.511,163,85,78,0.522,21,6,15,0.286,73,56,17,0.767,11,61,59
424,24,373,26,845,1.4,0.3,565,134,89,1.51,26,37,3,93,14,79,458,197,261,0.43,0.511,246,123,123,0.5,212,74,138,0.349,126,97,29,0.77,11,140,63
426,24,385,8,7,0.46,0.14,2,0,0,-,0,1,0,1,0,1,2,1,1,0.5,0.5,2,1,1,0.5,0,0,0,-,0,0,0,-,0,1,0
427,24,374,3,15,0.72,0.27,2,0,0,-,0,0,0,4,0,4,1,0,1,0,0,1,0,1,0,0,0,0,-,4,2,2,0.5,0,2,2
429,24,387,20,129,0.51,0.22,20,11,7,1.57,2,5,1,12,3,9,21,5,16,0.238,0.31,3,2,1,0.667,18,3,15,0.167,10,7,3,0.7,0,9,19
430,24,377,7,20,0.77,0.15,6,1,4,0.25,3,3,0,3,0,3,5,2,3,0.4,0.4,2,2,0,1,3,0,3,0,3,2,1,0.667,0,2,3
431,24,379,11,198,0.72,0.27,38,4,11,0.36,4,3,6,34,13,21,23,12,11,0.522,0.522,23,12,11,0.522,0,0,0,-,18,14,4,0.778,3,16,25
432,24,386,1,18,0.63,-0.06,4,0,1,0,0,1,0,1,0,1,1,1,0,1,1,1,1,0,1,0,0,0,-,2,2,0,1,0,1,1
433,24,381,11,29,0.56,0.31,8,1,3,0.33,0,0,1,8,3,5,7,4,3,0.571,0.571,7,4,3,0.571,0,0,0,-,3,0,3,0,0,3,3
435,24,388,4,4,1.53,0.75,2,0,0,-,0,0,1,1,0,1,1,1,0,1,1,1,1,0,1,0,0,0,-,0,0,0,-,0,0,0
436,24,383,26,795,1.11,0.44,278,89,66,1.35,31,38,35,146,24,122,203,93,110,0.458,0.51,135,72,63,0.533,68,21,47,0.309,102,71,31,0.696,9,89,46
438,24,375,18,105,0.22,0.11,12,5,6,0.83,1,2,0,9,3,6,13,5,8,0.385,0.462,6,3,3,0.5,7,2,5,0.286,1,0,1,0,0,1,10
439,24,389,26,530,0.65,0.27,133,22,10,2.2,10,3,2,68,28,40,113,50,63,0.442,0.518,66,33,33,0.5,47,17,30,0.362,17,16,1,0.941,3,15,32
440,24,380,26,602,1.65,0.45,404,31,31,1,6,21,11,197,40,157,280,141,139,0.504,0.589,162,93,69,0.574,118,48,70,0.407,96,74,22,0.771,11,70,55
441,24,382,26,673,0.68,0.23,171,56,38,1.47,24,22,0,61,11,50,122,53,69,0.434,0.57,52,20,32,0.385,70,33,37,0.471,39,32,7,0.82,2,25,39
442,24,378,25,210,0.65,0.38,38,5,5,1,5,3,6,44,14,30,39,15,24,0.385,0.397,34,14,20,0.412,5,1,4,0.2,11,7,4,0.636,1,12,40
443,24,376,26,611,1.29,0.5,286,23,34,0.68,7,12,33,189,56,133,198,123,75,0.621,0.626,188,121,67,0.644,10,2,8,0.2,52,38,14,0.731,11,40,87
444,24,384,10,25,1.35,0.96,9,2,2,1,0,1,2,14,6,8,9,3,6,0.333,0.444,2,1,1,0.5,7,2,5,0.286,4,1,3,0.25,0,2,4
446,25,394,18,110,0.76,0.35,38,9,14,0.64,15,10,1,14,3,11,35,19,16,0.543,0.543,33,19,14,0.576,2,0,2,0,0,0,0,-,0,1,14
447,25,402,29,959,1.09,0.26,467,39,59,0.66,14,21,7,206,39,167,348,168,180,0.483,0.556,200,117,83,0.585,148,51,97,0.345,110,80,30,0.727,15,80,81
448,25,401,29,982,1.11,0.51,333,153,35,4.37,36,14,11,139,29,110,245,125,120,0.51,0.551,193,105,88,0.544,52,20,32,0.385,82,63,19,0.768,8,58,41
449,25,404,22,213,0.47,0.15,54,3,9,0.33,3,4,1,26,9,17,66,17,49,0.258,0.341,22,6,16,0.273,44,11,33,0.25,12,9,3,0.75,0,7,13
450,25,398,15,67,0.29,0.24,11,3,4,0.75,1,1,0,12,4,8,21,5,16,0.238,0.262,11,4,7,0.364,10,1,9,0.1,0,0,0,-,0,1,7
451,25,400,29,978,1.49,0.41,603,93,77,1.21,52,34,7,211,40,171,458,232,226,0.506,0.537,343,204,139,0.595,115,28,87,0.243,150,111,39,0.74,14,120,85
452,25,393,21,86,0.36,0.16,15,4,7,0.57,2,3,2,10,2,8,15,5,10,0.333,0.467,1,1,0,1,14,4,10,0.286,3,1,2,0.333,0,2,9
453,25,390,4,40,0.99,0.48,11,3,0,-,2,0,0,7,2,5,9,3,6,0.333,0.444,3,1,2,0.333,6,2,4,0.333,4,3,1,0.75,0,2,6
454,25,392,3,4,3.13,1,2,1,0,-,0,0,0,2,0,2,0,0,0,-,-,0,0,0,-,0,0,0,-,3,2,1,0.667,0,2,0
455,25,391,6,26,0.29,0,8,0,1,0,1,1,0,0,0,0,9,3,6,0.333,0.444,1,1,0,1,8,2,6,0.25,0,0,0,-,0,0,1
456,25,406,9,123,1.14,0.43,57,6,6,1,11,3,2,20,7,13,45,21,24,0.467,0.533,29,15,14,0.517,16,6,10,0.375,19,9,10,0.474,1,14,18
457,25,408,29,937,1.17,0.34,420,60,25,2.4,25,6,9,140,42,98,284,132,152,0.465,0.584,117,64,53,0.547,167,68,99,0.407,111,88,23,0.793,6,72,56
458,25,405,29,569,0.65,0.15,182,21,27,0.78,18,14,1,54,8,46,154,59,95,0.383,0.506,37,21,16,0.568,117,38,79,0.325,32,26,6,0.812,1,18,62
459,25,396,9,29,0.49,0.48,4,1,3,0.33,1,1,0,10,6,4,7,2,5,0.286,0.286,7,2,5,0.286,0,0,0,-,2,0,2,0,0,2,9
460,25,397,11,28,0.27,0.11,6,0,2,0,0,0,0,5,2,3,8,2,6,0.25,0.375,0,0,0,-,8,2,6,0.25,0,0,0,-,0,1,3
461,25,403,14,41,1.11,0.39,14,4,2,2,0,1,1,7,3,4,11,4,7,0.364,0.364,9,4,5,0.444,2,0,2,0,12,6,6,0.5,0,6,3
462,25,407,21,140,0.58,0.29,30,2,14,0.14,1,5,6,40,10,30,28,13,15,0.464,0.464,28,13,15,0.464,0,0,0,-,9,4,5,0.444,3,10,30
464,25,395,17,124,0.72,0.34,38,8,5,1.6,2,3,5,16,6,10,38,13,25,0.342,0.461,9,4,5,0.444,29,9,20,0.31,4,3,1,0.75,0,2,14
465,25,399,26,382,0.57,0.19,112,7,19,0.37,12,7,6,53,8,45,107,42,65,0.392,0.467,58,26,32,0.448,49,16,33,0.326,25,12,13,0.48,3,23,64
468,26,415,9,14,0.45,-0.07,5,0,3,0,1,3,0,3,0,3,6,2,4,0.333,0.333,6,2,4,0.333,0,0,0,-,1,1,0,1,1,1,0
469,26,414,20,87,0.98,0.26,35,7,12,0.58,5,5,1,15,6,9,31,12,19,0.387,0.419,23,10,13,0.435,8,2,6,0.25,13,9,4,0.692,4,13,13
470,26,410,2,11,0.33,0.27,2,2,1,2,0,0,0,1,0,1,4,1,3,0.25,0.25,2,1,1,0.5,2,0,2,0,0,0,0,-,0,0,1
471,26,420,14,107,0.92,0.48,30,14,4,3.5,3,2,2,16,5,11,33,9,24,0.273,0.348,14,4,10,0.286,19,5,14,0.263,8,7,1,0.875,0,6,11
472,26,427,26,714,0.95,0.33,320,20,45,0.44,19,20,8,172,63,109,296,133,163,0.449,0.486,235,111,124,0.472,61,22,39,0.361,50,32,18,0.64,9,53,66
473,26,412,24,664,1.07,0.23,355,44,33,1.33,7,24,3,102,12,90,320,124,196,0.388,0.466,167,74,93,0.443,153,50,103,0.327,67,57,10,0.851,5,56,41
474,26,424,26,819,1.17,0.41,390,103,31,3.32,39,20,2,86,24,62,305,151,154,0.495,0.554,216,115,101,0.532,89,36,53,0.404,68,52,16,0.765,7,68,50
475,26,416,9,26,0.57,0.65,4,3,0,-,3,0,0,5,0,5,11,2,9,0.182,0.182,5,2,3,0.4,6,0,6,0,1,0,1,0,0,1,4
476,26,521,1,24,1.69,0.13,23,1,5,0.2,1,0,1,6,1,5,15,10,5,0.667,0.7,12,9,3,0.75,3,1,2,0.333,2,2,0,1,0,0,4
587,31,521,26,646,1.42,0.43,424,39,80,0.49,27,32,27,198,55,143,369,180,189,0.488,0.499,333,172,161,0.516,36,8,28,0.222,85,56,29,0.659,16,71,70
477,26,423,4,11,-0.26,-0.09,3,0,1,0,0,1,0,1,0,1,9,1,8,0.111,0.167,1,0,1,0,8,1,7,0.125,0,0,0,-,0,0,0
478,26,422,11,33,0.83,0.48,9,3,2,1.5,1,2,0,7,5,2,7,4,3,0.571,0.643,5,3,2,0.6,2,1,1,0.5,0,0,0,-,0,1,3
479,26,429,26,694,0.99,0.43,267,71,35,2.03,32,21,16,102,26,76,236,95,141,0.402,0.496,118,51,67,0.432,118,44,74,0.373,44,33,11,0.75,7,45,70
480,26,418,23,399,0.9,0.32,152,17,12,1.42,12,10,6,68,15,53,122,56,66,0.459,0.545,59,35,24,0.593,63,21,42,0.333,31,19,12,0.613,4,25,51
481,26,421,22,518,1.16,0.44,224,35,43,0.81,21,19,21,132,27,105,174,84,90,0.483,0.534,117,66,51,0.564,57,18,39,0.316,53,38,15,0.717,6,44,59
482,26,428,25,283,0.52,0.2,74,8,17,0.47,10,12,2,33,17,16,76,27,49,0.355,0.447,27,13,14,0.482,49,14,35,0.286,7,6,1,0.857,0,7,12
483,26,426,11,21,0.89,0.62,6,0,0,-,0,0,1,9,2,7,7,3,4,0.429,0.429,7,3,4,0.429,0,0,0,-,0,0,0,-,0,1,6
484,26,413,4,13,0.71,0.38,5,0,2,0,1,0,0,4,3,1,6,2,4,0.333,0.417,4,1,3,0.25,2,1,1,0.5,0,0,0,-,0,1,5
485,26,411,15,78,0.86,0.36,28,1,10,0.1,0,2,5,28,8,20,24,13,11,0.542,0.542,24,13,11,0.542,0,0,0,-,3,2,1,0.667,1,3,15
486,26,417,26,580,0.93,0.46,187,27,18,1.5,20,9,21,131,38,93,168,67,101,0.399,0.479,87,40,47,0.46,81,27,54,0.333,41,26,15,0.634,5,27,64
487,26,419,14,46,0.43,0.37,2,0,0,-,0,0,3,9,2,7,8,0,8,0,0,1,0,1,0,7,0,7,0,2,2,0,1,0,1,4
488,26,425,10,14,0.81,0.5,4,1,0,-,1,0,0,2,1,1,4,2,2,0.5,0.5,4,2,2,0.5,0,0,0,-,0,0,0,-,0,0,2
489,26,409,3,10,0.13,0.4,0,0,1,0,0,1,0,4,2,2,3,0,3,0,0,3,0,3,0,0,0,0,-,0,0,0,-,0,1,2
490,27,445,25,398,0.95,0.28,156,15,37,0.41,25,16,1,93,11,82,114,57,57,0.5,0.579,69,39,30,0.565,45,18,27,0.4,28,24,4,0.857,2,23,45
491,27,439,7,14,0.94,0.5,5,4,2,2,0,2,0,3,0,3,4,2,2,0.5,0.625,1,1,0,1,3,1,2,0.333,0,0,0,-,0,0,1
492,27,433,26,369,0.6,0.35,67,39,17,2.29,15,9,3,44,4,40,65,28,37,0.431,0.446,51,26,25,0.51,14,2,12,0.143,15,9,6,0.6,2,10,20
493,27,435,24,634,1.13,0.45,257,82,30,2.73,33,17,2,97,13,84,193,83,110,0.43,0.56,62,33,29,0.532,131,50,81,0.382,45,41,4,0.911,6,42,29
494,27,432,26,254,1.18,0.3,109,6,27,0.22,15,9,8,56,16,40,70,39,31,0.557,0.557,70,39,31,0.557,0,0,0,-,48,31,17,0.646,4,36,41
496,27,436,7,12,1.36,0.42,7,0,2,0,1,2,0,5,2,3,5,3,2,0.6,0.6,5,3,2,0.6,0,0,0,-,2,1,1,0.5,0,1,3
498,27,443,21,201,0.46,0.19,33,12,13,0.92,7,4,1,19,5,14,29,11,18,0.379,0.466,14,6,8,0.429,15,5,10,0.333,7,6,1,0.857,0,6,21
499,27,431,27,289,1.04,0.29,127,12,16,0.75,2,5,8,53,19,34,95,53,42,0.558,0.558,95,53,42,0.558,0,0,0,-,29,21,8,0.724,2,24,37
500,27,430,27,695,1.09,0.46,276,33,50,0.66,15,21,41,188,55,133,199,123,76,0.618,0.618,199,123,76,0.618,0,0,0,-,52,30,22,0.577,6,41,54
501,27,438,27,667,1.32,0.27,407,42,62,0.68,13,23,14,147,21,126,310,145,165,0.468,0.544,193,98,95,0.508,117,47,70,0.402,80,70,10,0.875,7,73,58
502,27,442,3,6,0.38,0.67,0,1,0,-,1,0,0,0,0,0,2,0,2,0,0,1,0,1,0,1,0,1,0,0,0,0,-,0,0,1
503,27,437,15,72,0.85,0.46,16,4,4,1,5,2,2,13,6,7,13,6,7,0.462,0.5,8,5,3,0.625,5,1,4,0.2,3,3,0,1,1,3,10
504,27,444,15,224,0.5,0.35,25,24,10,2.4,13,5,1,20,3,17,24,11,13,0.458,0.479,20,10,10,0.5,4,1,3,0.25,3,2,1,0.667,1,7,20
505,27,434,9,33,1.49,0.39,19,0,1,0,1,0,1,8,3,5,11,8,3,0.727,0.727,10,8,2,0.8,1,0,1,0,3,3,0,1,1,2,6
506,27,440,27,572,0.73,0.2,190,41,59,0.69,20,23,4,83,20,63,181,65,116,0.359,0.425,97,41,56,0.423,84,24,60,0.286,45,36,9,0.8,4,36,68
507,27,441,27,753,1.31,0.21,455,50,68,0.74,28,42,1,120,19,101,346,153,193,0.442,0.517,205,101,104,0.493,141,52,89,0.369,115,97,18,0.844,9,83,66
508,28,458,5,7,0.54,0,3,0,0,-,0,0,0,0,0,0,2,1,1,0.5,0.75,1,0,1,0,1,1,0,1,0,0,0,-,0,0,1
509,28,452,25,539,0.41,0.16,106,50,38,1.32,9,19,0,37,9,28,127,36,91,0.284,0.354,69,18,51,0.261,58,18,40,0.31,22,16,6,0.727,2,22,33
510,28,449,25,492,0.76,0.18,139,37,25,1.48,10,15,0,38,5,33,111,40,71,0.36,0.423,59,26,33,0.441,52,14,38,0.269,54,45,9,0.833,2,39,23
511,28,448,7,23,0.53,0.35,3,1,1,1,0,1,0,6,2,4,4,1,3,0.25,0.25,4,1,3,0.25,0,0,0,-,2,1,1,0.5,0,1,4
512,28,457,21,299,0.9,0.61,57,14,11,1.27,16,5,9,94,31,63,50,24,26,0.48,0.48,48,24,24,0.5,2,0,2,0,15,9,6,0.6,0,10,31
513,28,451,25,381,0.61,0.25,103,32,19,1.68,8,7,1,42,8,34,102,37,65,0.363,0.441,50,21,29,0.42,52,16,36,0.308,20,13,7,0.65,3,18,41
514,28,450,25,779,1.17,0.21,429,59,88,0.67,32,48,15,102,29,73,350,162,188,0.463,0.496,260,139,121,0.535,90,23,67,0.256,102,82,20,0.804,12,78,65
516,28,461,14,83,0.91,0.16,41,8,8,1,0,4,0,12,1,11,27,13,14,0.482,0.685,5,2,3,0.4,22,11,11,0.5,6,4,2,0.667,0,4,7
517,28,456,24,602,1.16,0.36,233,57,49,1.16,29,31,9,96,28,68,153,71,82,0.464,0.546,89,46,43,0.517,64,25,39,0.391,86,66,20,0.767,4,67,58
518,28,455,19,78,0.68,0.36,11,4,3,1.33,2,2,2,14,4,10,11,3,8,0.273,0.273,10,3,7,0.3,1,0,1,0,6,5,1,0.833,0,3,6
519,28,462,18,91,0.58,0.21,22,8,8,1,5,6,0,7,2,5,19,8,11,0.421,0.474,13,6,7,0.462,6,2,4,0.333,8,4,4,0.5,0,6,10
520,28,446,3,10,0.89,0.2,4,0,0,-,0,0,0,2,0,2,3,1,2,0.333,0.5,0,0,0,-,3,1,2,0.333,2,1,1,0.5,0,1,2
522,28,460,6,24,0.53,0.25,2,0,3,0,0,3,0,8,4,4,3,0,3,0,0,2,0,2,0,1,0,1,0,2,2,0,1,0,1,4
523,28,454,8,15,0.24,0.27,2,0,0,-,0,0,1,2,0,2,5,1,4,0.2,0.2,4,1,3,0.25,1,0,1,0,0,0,0,-,0,0,1
524,28,447,6,13,0.56,0.15,4,1,1,1,1,0,0,0,0,0,3,2,1,0.667,0.667,3,2,1,0.667,0,0,0,-,0,0,0,-,0,0,0
525,28,459,24,226,0.94,0.54,54,8,10,0.8,7,3,12,67,22,45,47,22,25,0.468,0.468,47,22,25,0.468,0,0,0,-,13,10,3,0.769,1,9,48
526,28,453,25,832,1.45,0.26,537,24,67,0.36,21,35,2,200,55,145,418,193,225,0.462,0.494,339,166,173,0.49,79,27,52,0.342,160,124,36,0.775,12,123,64
527,28,463,25,597,0.98,0.41,189,29,49,0.59,11,19,17,180,49,131,136,64,72,0.471,0.548,85,43,42,0.506,51,21,30,0.412,58,40,18,0.69,3,50,82
528,29,484,24,326,0.63,0.3,83,15,21,0.71,3,8,9,67,18,49,79,38,41,0.481,0.481,79,38,41,0.481,0,0,0,-,12,7,5,0.583,2,14,36
529,29,469,7,16,0.31,0.13,3,1,2,0.5,1,1,0,2,0,2,3,1,2,0.333,0.5,1,0,1,0,2,1,1,0.5,0,0,0,-,0,0,2
530,29,482,25,684,0.95,0.45,223,65,31,2.1,60,18,1,89,28,61,201,85,116,0.423,0.468,146,67,79,0.459,55,18,37,0.327,50,35,15,0.7,3,34,45
531,29,479,23,311,0.57,0.21,72,20,16,1.25,9,7,2,30,4,26,76,23,53,0.303,0.368,32,13,19,0.406,44,10,34,0.227,20,16,4,0.8,3,15,24
532,29,483,24,343,0.74,0.31,132,14,12,1.17,14,7,6,49,15,34,122,47,75,0.385,0.537,18,10,8,0.556,104,37,67,0.356,3,1,2,0.333,1,6,37
533,29,478,24,357,0.79,0.24,132,35,32,1.09,17,19,4,34,5,29,114,51,63,0.447,0.496,85,40,45,0.471,29,11,18,0.379,34,19,15,0.559,5,23,36
534,29,465,11,16,0.93,0.31,8,0,2,0,1,2,0,6,1,5,6,3,3,0.5,0.667,2,1,1,0.5,4,2,2,0.5,0,0,0,-,0,0,2
536,29,476,13,54,0.36,-0.02,14,1,3,0.33,0,1,0,3,0,3,12,4,8,0.333,0.5,1,0,1,0,11,4,7,0.364,3,2,1,0.667,0,2,2
537,29,470,7,101,0.42,0.2,28,3,6,0.5,4,2,2,9,5,4,36,12,24,0.333,0.375,22,9,13,0.409,14,3,11,0.214,5,1,4,0.2,1,6,17
538,29,464,23,655,1.5,0.5,336,41,71,0.58,16,26,31,230,63,167,236,123,113,0.521,0.521,235,123,112,0.523,1,0,1,0,140,90,50,0.643,9,110,53
539,29,466,14,67,0.14,0.1,4,2,3,0.67,1,1,0,6,1,5,6,2,4,0.333,0.333,6,2,4,0.333,0,0,0,-,0,0,0,-,0,1,10
540,29,474,14,61,0.51,0.25,14,7,4,1.75,1,4,1,5,0,5,15,5,10,0.333,0.433,2,2,0,1,13,3,10,0.231,2,1,1,0.5,0,1,6
541,29,473,14,72,0.49,0.15,17,2,5,0.4,1,2,2,10,1,9,11,6,5,0.546,0.727,3,2,1,0.667,8,4,4,0.5,2,1,1,0.5,0,1,8
542,29,477,15,290,0.64,0.31,68,18,15,1.2,11,9,0,40,23,17,80,24,56,0.3,0.338,52,18,34,0.346,28,6,22,0.214,21,14,7,0.667,0,19,43
543,29,471,21,439,0.94,0.37,165,33,26,1.27,38,16,3,54,11,43,164,61,103,0.372,0.415,112,47,65,0.42,52,14,38,0.269,36,29,7,0.806,4,35,55
544,29,472,15,207,1.07,0.19,98,11,23,0.48,5,8,2,35,14,21,70,32,38,0.457,0.529,48,22,26,0.458,22,10,12,0.454,37,24,13,0.649,2,23,27
545,29,481,23,368,1.05,0.41,154,10,12,0.83,7,6,18,81,24,57,132,62,70,0.47,0.504,99,53,46,0.535,33,9,24,0.273,30,21,9,0.7,6,27,37
546,29,480,22,319,0.62,0.17,73,8,12,0.67,6,4,2,39,7,32,73,18,55,0.247,0.322,31,7,24,0.226,42,11,31,0.262,30,26,4,0.867,1,17,25
547,29,467,7,19,0.52,0.37,1,3,3,1,0,2,1,4,1,3,1,0,1,0,0,1,0,1,0,0,0,0,-,2,1,1,0.5,0,1,0
548,29,468,18,377,1.03,0.27,162,38,30,1.27,17,11,0,43,8,35,138,58,80,0.42,0.446,115,51,64,0.444,23,7,16,0.304,56,39,17,0.696,3,40,41
549,29,475,6,17,0.83,0,10,0,1,0,0,0,0,1,1,0,9,4,5,0.444,0.5,8,3,5,0.375,1,1,0,1,1,1,0,1,1,1,4
550,30,488,22,138,0.72,0.17,34,8,16,0.5,4,3,3,20,5,15,21,11,10,0.524,0.524,19,11,8,0.579,2,0,2,0,18,12,6,0.667,1,20,16
551,30,504,24,177,0.53,0.12,66,5,15,0.33,4,6,0,23,11,12,63,23,40,0.365,0.516,8,4,4,0.5,55,19,36,0.346,2,1,1,0.5,0,2,19
552,30,491,6,25,0.73,-0.08,9,1,6,0.17,2,3,0,3,1,2,3,3,0,1,0,2,2,0,1,1,1,0,1,2,2,0,1,0,2,3
553,30,498,19,416,0.86,0.16,158,15,30,0.5,10,19,2,57,17,40,126,50,76,0.397,0.476,74,30,44,0.405,52,20,32,0.385,47,38,9,0.808,3,29,34
554,30,501,25,795,1.31,0.3,494,74,64,1.16,36,33,3,123,19,104,419,182,237,0.434,0.489,277,136,141,0.491,142,46,96,0.324,110,84,26,0.764,19,99,63
555,30,487,22,434,0.78,0.15,204,46,45,1.02,15,22,0,25,8,17,194,75,119,0.387,0.477,96,40,56,0.417,98,35,63,0.357,21,19,2,0.905,0,21,26
556,30,502,25,515,0.49,0.34,70,52,31,1.68,23,22,2,70,12,58,79,29,50,0.367,0.411,48,22,26,0.458,31,7,24,0.226,12,5,7,0.417,1,13,58
557,30,490,13,293,1.18,0.47,139,12,10,1.2,22,4,2,64,21,43,124,55,69,0.444,0.484,96,45,51,0.469,28,10,18,0.357,26,19,7,0.731,4,19,36
558,30,505,21,162,0.8,0.31,57,12,5,2.4,8,6,1,18,1,17,58,20,38,0.345,0.414,29,12,17,0.414,29,8,21,0.276,15,9,6,0.6,0,11,14
559,30,499,22,120,0.28,0.26,10,4,6,0.67,8,2,0,16,3,13,20,4,16,0.2,0.25,9,2,7,0.222,11,2,9,0.182,0,0,0,-,0,1,14
560,30,506,7,25,0.44,0.08,7,1,3,0.33,0,1,0,4,2,2,7,2,5,0.286,0.429,2,0,2,0,5,2,3,0.4,2,1,1,0.5,0,1,2
561,30,489,7,180,1.09,0.27,66,22,15,1.47,5,3,2,19,2,17,42,21,21,0.5,0.536,29,18,11,0.621,13,3,10,0.231,24,21,3,0.875,2,15,15
563,30,492,5,9,2.12,1,5,1,0,-,1,0,1,2,1,1,3,2,1,0.667,0.667,2,2,0,1,1,0,1,0,1,1,0,1,1,2,0
564,30,493,7,193,1.03,0.37,80,9,18,0.5,4,9,3,56,19,37,67,30,37,0.448,0.5,49,23,26,0.469,18,7,11,0.389,19,13,6,0.684,2,12,18
565,30,485,10,39,0.5,0.33,6,1,1,1,2,0,0,6,3,3,6,3,3,0.5,0.5,6,3,3,0.5,0,0,0,-,0,0,0,-,0,1,8
566,30,486,24,230,0.86,0.4,57,12,12,1,5,5,2,53,26,27,43,22,21,0.512,0.512,42,22,20,0.524,1,0,1,0,20,13,7,0.65,0,14,43
567,30,494,3,8,1.31,0.25,6,1,0,-,0,0,0,0,0,0,3,2,1,0.667,1,0,0,0,-,3,2,1,0.667,0,0,0,-,0,0,1
568,30,495,25,574,1.1,0.36,268,19,58,0.33,16,20,21,153,55,98,232,110,122,0.474,0.485,217,105,112,0.484,15,5,10,0.333,58,43,15,0.741,10,49,71
569,30,497,16,163,0.84,0.25,57,2,8,0.25,1,3,2,35,12,23,53,22,31,0.415,0.415,53,22,31,0.415,0,0,0,-,19,13,6,0.684,0,16,19
570,30,496,7,92,0.72,0.09,26,1,9,0.11,1,4,2,14,4,10,18,8,10,0.444,0.444,18,8,10,0.444,0,0,0,-,15,10,5,0.667,1,6,7
571,30,503,2,22,0.08,0.18,2,3,6,0.5,0,3,3,4,0,4,7,1,6,0.143,0.143,6,1,5,0.167,1,0,1,0,0,0,0,-,0,0,2
572,30,500,6,14,1.64,0.5,6,2,2,1,1,3,0,4,1,3,5,1,4,0.2,0.2,3,1,2,0.333,2,0,2,0,7,4,3,0.571,1,4,3
573,31,516,28,631,0.55,0.24,113,51,35,1.46,14,16,1,72,18,54,100,38,62,0.38,0.44,48,26,22,0.542,52,12,40,0.231,35,25,10,0.714,2,30,82
574,31,520,28,893,0.65,0.33,176,111,34,3.26,28,17,2,74,9,65,165,59,106,0.358,0.418,93,39,54,0.419,72,20,52,0.278,60,38,22,0.633,2,58,55
575,31,509,14,24,0.18,0.25,0,1,0,-,2,0,0,0,0,0,2,0,2,0,0,2,0,2,0,0,0,0,-,0,0,0,-,0,0,9
576,31,522,13,228,0.79,0.35,77,24,20,1.2,4,9,9,35,10,25,74,33,41,0.446,0.466,66,30,36,0.454,8,3,5,0.375,15,8,7,0.533,1,18,34
577,31,507,28,456,0.69,0.15,155,24,23,1.04,8,12,1,42,5,37,141,49,92,0.348,0.447,61,21,40,0.344,80,28,52,0.35,33,29,4,0.879,0,26,34
578,31,514,28,768,1.05,0.25,330,64,46,1.39,13,23,4,108,14,94,261,99,162,0.379,0.473,126,50,76,0.397,135,49,86,0.363,109,83,26,0.761,12,78,47
579,31,517,19,74,0.27,0.24,5,1,1,1,1,0,0,13,3,10,11,2,9,0.182,0.182,10,2,8,0.2,1,0,1,0,2,1,1,0.5,0,2,8
580,31,512,28,404,0.41,0.25,40,29,23,1.26,13,8,0,52,12,40,43,13,30,0.302,0.36,18,8,10,0.444,25,5,20,0.2,13,9,4,0.692,0,14,41
581,31,510,9,75,0.29,-0.05,22,3,6,0.5,1,4,0,0,0,0,20,7,13,0.35,0.525,5,0,5,0,15,7,8,0.467,2,1,1,0.5,0,2,4
583,31,511,27,677,1.15,0.35,292,35,40,0.88,10,14,7,169,44,125,209,114,95,0.546,0.553,203,111,92,0.547,6,3,3,0.5,80,61,19,0.762,8,64,60
584,31,513,8,14,0.33,-0.14,6,0,1,0,0,1,0,0,0,0,6,2,4,0.333,0.417,3,1,2,0.333,3,1,2,0.333,4,1,3,0.25,0,2,0
585,31,515,19,92,0.73,0.29,31,4,1,4,0,1,0,19,2,17,30,13,17,0.433,0.483,15,10,5,0.667,15,3,12,0.2,2,2,0,1,0,3,8
586,31,519,13,54,1.47,0.28,23,4,1,4,1,0,0,5,2,3,17,5,12,0.294,0.294,17,5,12,0.294,0,0,0,-,14,13,1,0.929,0,9,5
588,31,523,7,4,1.83,1.25,2,1,0,-,1,0,0,1,0,1,1,1,0,1,1,1,1,0,1,0,0,0,-,1,0,1,0,0,1,0
589,31,508,28,404,1.1,0.18,211,5,25,0.2,7,11,3,69,23,46,163,84,79,0.515,0.524,156,81,75,0.519,7,3,4,0.429,49,40,9,0.816,8,40,39
592,31,518,11,39,0.27,0.1,5,0,4,0,1,1,0,10,0,10,5,2,3,0.4,0.4,5,2,3,0.4,0,0,0,-,3,1,2,0.333,0,3,10
594,32,538,27,820,1.14,0.5,300,105,70,1.5,33,49,42,163,28,135,237,112,125,0.473,0.481,223,108,115,0.484,14,4,10,0.286,135,72,63,0.533,23,109,59
595,32,534,22,213,0.46,0.26,35,22,11,2,5,10,0,20,3,17,39,11,28,0.282,0.385,8,3,5,0.375,31,8,23,0.258,9,5,4,0.556,0,8,26
596,32,531,12,68,0.32,0.29,2,9,8,1.12,2,8,0,11,3,8,3,1,2,0.333,0.333,1,1,0,1,2,0,2,0,0,0,0,-,0,0,4
597,32,528,26,614,0.97,0.33,249,64,36,1.78,38,24,4,51,13,38,206,91,115,0.442,0.519,103,59,44,0.573,103,32,71,0.311,45,35,10,0.778,4,34,26
598,32,539,13,298,1.01,0.27,136,22,25,0.88,13,6,0,50,10,40,120,50,70,0.417,0.458,87,40,47,0.46,33,10,23,0.303,39,26,13,0.667,7,32,29
599,32,533,24,180,0.45,0.34,8,11,10,1.1,9,3,0,32,10,22,6,2,4,0.333,0.333,6,2,4,0.333,0,0,0,-,7,4,3,0.571,1,13,22
603,32,532,26,544,1.32,0.53,246,36,30,1.2,17,13,12,162,56,106,192,94,98,0.49,0.518,165,83,82,0.503,27,11,16,0.407,58,47,11,0.81,6,43,48
604,32,530,6,12,0.03,-0.17,2,0,2,0,0,2,0,1,1,0,2,1,1,0.5,0.5,1,1,0,1,1,0,1,0,0,0,0,-,0,0,1
605,32,529,3,8,-0.38,0.13,0,0,1,0,0,0,0,2,1,1,5,0,5,0,0,0,0,0,-,5,0,5,0,0,0,0,-,0,0,1
606,32,525,20,261,0.74,0.33,92,7,9,0.78,10,3,2,51,16,35,79,38,41,0.481,0.576,38,23,15,0.605,41,15,26,0.366,6,1,5,0.167,1,9,26
607,32,524,10,24,-0.02,0,2,2,3,0.67,0,1,0,2,0,2,4,1,3,0.25,0.25,4,1,3,0.25,0,0,0,-,1,0,1,0,0,1,8
608,32,535,9,52,0.33,-0.02,14,1,8,0.12,3,4,1,4,1,3,12,6,6,0.5,0.542,8,5,3,0.625,4,1,3,0.25,3,1,2,0.333,1,4,5
610,32,526,25,357,0.46,0.19,95,14,10,1.4,9,7,2,32,6,26,95,33,62,0.347,0.495,11,5,6,0.454,84,28,56,0.333,4,1,3,0.25,0,5,13
611,32,537,27,764,1.24,0.29,454,44,59,0.75,17,36,3,158,56,102,383,183,200,0.478,0.501,346,165,181,0.477,37,18,19,0.486,91,70,21,0.769,9,72,75
613,32,527,16,442,0.65,0.2,130,41,46,0.89,9,25,0,64,16,48,127,42,85,0.331,0.413,66,21,45,0.318,61,21,40,0.344,34,25,9,0.735,0,35,26
615,32,536,27,531,1.05,0.35,231,25,28,0.89,14,16,5,116,36,80,197,91,106,0.462,0.49,169,80,89,0.473,28,11,17,0.393,52,38,14,0.731,7,34,67
