player_id,team_cumulative_id,team_id,min,sst,sstexpts,pts,ast,turnover,ast_to_ratio,stl,stlpos,blk,ttlreb,offreb,defreb,field_goals_attempt,field_goals_made,field_goals_missed,field_goal_percentage,adjusted_field_goal_percentage,two_field_goals_attempt,two_field_goals_made,two_field_goals_missed,two_field_goal_percentage,three_field_goals_attempt,three_field_goals_made,three_field_goals_missed,three_field_goal_percentage,free_throw_attempts,free_throw_made,free_throw_missed,free_throw_percentage,and_one,personal_fouls_taken,total_personal_fouls_commited,gp
1,230,13,209,0.71,0.23,54,8,10,0.8,5,6,1,31,9,22,45,18,27,0.4,0.444,28,14,14,0.5,17,4,13,0.235,19,14,5,0.737,0,11,23,18
2,223,13,399,0.84,0.27,135,34,33,1.03,11,16,0,69,15,54,116,46,70,0.397,0.461,66,31,35,0.47,50,15,35,0.3,42,28,14,0.667,3,34,34,23
3,218,13,192,0.89,0.22,86,14,9,1.56,6,6,0,16,4,12,77,29,48,0.377,0.474,36,14,22,0.389,41,15,26,0.366,17,13,4,0.765,1,11,7,18
4,225,13,13,1.19,0.54,2,3,0,,0,0,0,1,0,1,1,0,1,0,0,0,0,0,,1,0,1,0,2,2,0,1,0,1,1,5
5,227,13,371,0.93,0.34,137,16,20,0.8,2,5,3,96,29,67,133,51,82,0.384,0.413,97,43,54,0.443,36,8,28,0.222,35,27,8,0.771,3,37,46,25
6,216,13,520,1.52,0.43,289,58,39,1.49,21,24,4,103,33,70,210,97,113,0.462,0.507,154,78,76,0.506,56,19,37,0.339,103,76,27,0.738,19,89,43,22
7,219,13,282,0.38,0.17,56,9,4,2.25,6,2,1,24,0,24,57,19,38,0.333,0.482,7,2,5,0.286,50,17,33,0.34,2,1,1,0.5,0,1,27,19
9,221,13,462,0.74,0.27,163,38,43,0.88,8,17,5,94,17,77,148,57,91,0.385,0.5,59,23,36,0.39,89,34,55,0.382,22,15,7,0.682,1,19,52,25
10,222,13,167,0.9,0.2,70,15,11,1.36,3,7,0,14,6,8,54,24,30,0.444,0.528,29,15,14,0.517,25,9,16,0.36,21,13,8,0.619,3,13,19,14
11,224,13,384,0.9,0.14,170,14,21,0.67,10,9,3,37,4,33,138,56,82,0.406,0.489,73,33,40,0.452,65,23,42,0.354,46,35,11,0.761,2,23,42,20
12,226,13,115,0.68,0.31,27,3,9,0.33,5,4,7,19,5,14,26,11,15,0.423,0.423,25,11,14,0.44,1,0,1,0,7,5,2,0.714,0,5,8,17
13,217,13,49,0.38,0.29,9,4,4,1,1,3,0,9,3,6,14,3,11,0.214,0.321,3,0,3,0,11,3,8,0.273,0,0,0,,0,0,2,6
14,228,13,389,1.13,0.41,194,13,28,0.46,4,14,16,103,47,56,156,85,71,0.545,0.564,136,79,57,0.581,20,6,14,0.3,35,18,17,0.514,6,35,48,23
15,215,13,451,0.62,0.26,89,53,32,1.66,12,18,0,40,11,29,83,25,58,0.301,0.38,43,12,31,0.279,40,13,27,0.325,33,26,7,0.788,0,29,26,25
16,231,13,331,1.41,0.52,165,22,28,0.79,4,12,8,115,44,71,102,69,33,0.676,0.676,102,69,33,0.676,0,0,0,,44,27,17,0.614,1,36,54,23
17,106,7,11,0.05,0,2,0,0,,0,0,0,0,0,0,3,1,2,0.333,0.333,2,1,1,0.5,1,0,1,0,1,0,1,0,0,0,1,5
18,112,7,919,1.28,0.48,403,73,62,1.18,52,24,37,178,66,112,263,149,114,0.566,0.624,192,119,73,0.62,71,30,41,0.422,112,75,37,0.67,19,81,61,25
19,118,7,588,1.03,0.38,251,15,43,0.35,7,15,41,148,33,115,195,110,85,0.564,0.564,195,110,85,0.564,0,0,0,,59,31,28,0.525,11,58,54,25
20,109,7,13,0.43,0.15,4,1,1,1,0,1,0,2,0,2,5,2,3,0.4,0.4,4,2,2,0.5,1,0,1,0,0,0,0,,0,0,0,3
21,113,7,9,0.97,0.11,2,1,1,1,0,0,0,1,0,1,2,0,2,0,0,0,0,0,,2,0,2,0,2,2,0,1,0,1,0,5
22,104,7,566,0.75,0.13,213,43,54,0.8,22,17,2,38,11,27,192,72,120,0.375,0.445,103,45,58,0.437,89,27,62,0.303,50,42,8,0.84,8,38,64,24
23,116,7,24,-0.13,-0.13,0,0,3,0,0,3,0,3,0,3,0,0,0,,,0,0,0,,0,0,0,,0,0,0,,0,0,2,8
24,107,7,121,0.6,0.3,29,8,2,4,2,1,0,17,3,14,31,9,22,0.29,0.403,7,2,5,0.286,24,7,17,0.292,7,4,3,0.571,1,4,5,13
25,103,7,814,1.24,0.3,426,51,29,1.76,23,13,0,132,23,109,320,138,182,0.431,0.53,174,75,99,0.431,146,63,83,0.432,101,87,14,0.861,13,65,34,24
26,117,7,103,0.37,0.09,31,3,8,0.38,0,2,2,13,2,11,34,11,23,0.324,0.456,5,2,3,0.4,29,9,20,0.31,0,0,0,,0,0,14,12
27,110,7,475,0.78,0.44,90,62,26,2.38,18,12,6,78,13,65,77,28,49,0.364,0.454,34,14,20,0.412,43,14,29,0.326,23,20,3,0.87,2,22,44,18
28,111,7,357,1.43,0.16,217,28,38,0.74,8,17,2,43,14,29,147,67,80,0.456,0.52,100,48,52,0.48,47,19,28,0.404,80,64,16,0.8,6,62,46,13
29,108,7,160,0.51,0.18,34,10,9,1.11,3,4,0,19,2,17,30,11,19,0.367,0.467,13,5,8,0.385,17,6,11,0.353,9,6,3,0.667,0,5,12,19
30,115,7,363,1.03,0.58,88,9,13,0.69,4,6,46,88,30,58,59,34,25,0.576,0.576,59,34,25,0.576,0,0,0,,37,20,17,0.54,1,25,38,23
31,114,7,412,0.53,0.28,76,24,10,2.4,10,7,4,49,10,39,87,23,64,0.264,0.345,23,9,14,0.391,64,14,50,0.219,31,16,15,0.516,2,22,46,25
32,105,7,123,0.3,0.01,20,3,7,0.43,3,2,0,3,0,3,19,6,13,0.316,0.395,3,3,0,1,16,3,13,0.188,6,5,1,0.833,0,4,7,16
33,211,12,2,0.5,0.5,0,0,1,0,0,0,0,2,1,1,0,0,0,,,0,0,0,,0,0,0,,0,0,0,,0,0,1,2
34,198,12,159,0.91,0.64,40,18,4,4.5,6,3,1,42,17,25,47,19,28,0.404,0.404,44,19,25,0.432,3,0,3,0,2,2,0,1,0,1,16,20
35,197,12,716,1.29,0.47,308,53,47,1.13,25,16,7,201,56,145,242,103,139,0.426,0.467,181,83,98,0.459,61,20,41,0.328,107,82,25,0.766,13,90,47,23
36,203,12,193,0.96,0.45,64,5,9,0.56,3,5,2,57,28,29,61,24,37,0.393,0.418,45,21,24,0.467,16,3,13,0.188,25,13,12,0.52,1,16,16,25
37,201,12,2,3.48,0,3,0,0,,0,0,0,0,0,0,2,1,1,0.5,0.5,1,1,0,1,1,0,1,0,1,1,0,1,1,1,0,1
38,206,12,236,0.48,0.11,65,20,24,0.83,1,13,0,28,3,25,59,22,37,0.373,0.492,22,8,14,0.364,37,14,23,0.378,10,7,3,0.7,2,13,14,24
39,202,12,775,0.96,0.1,436,36,44,0.82,14,21,3,50,8,42,345,140,205,0.406,0.551,85,40,45,0.471,260,100,160,0.385,68,56,12,0.824,5,50,34,25
40,207,12,752,0.85,0.52,185,142,54,2.63,35,32,11,117,6,111,155,61,94,0.394,0.552,31,12,19,0.387,124,49,75,0.395,17,14,3,0.824,1,15,47,25
41,212,12,377,1.12,0.3,152,22,24,0.92,5,6,2,65,38,27,110,50,60,0.454,0.468,87,47,40,0.54,23,3,20,0.13,82,49,33,0.598,10,51,41,25
42,199,12,2,0,0,0,0,2,0,0,0,0,2,2,0,0,0,0,,,0,0,0,,0,0,0,,0,0,0,,0,0,1,3
43,209,12,151,0.43,0.32,23,10,9,1.11,3,4,4,26,7,19,32,8,24,0.25,0.359,7,1,6,0.143,25,7,18,0.28,0,0,0,,0,2,8,24
44,205,12,340,0.86,0.32,92,24,23,1.04,15,9,0,59,17,42,60,32,28,0.533,0.558,54,29,25,0.537,6,3,3,0.5,37,25,12,0.676,0,29,38,25
45,200,12,596,0.66,0.16,234,27,26,1.04,8,14,7,55,8,47,227,85,142,0.374,0.476,82,39,43,0.476,145,46,99,0.317,23,18,5,0.783,0,18,50,25
46,204,12,1,0,0,0,0,0,,0,0,0,0,0,0,0,0,0,,,0,0,0,,0,0,0,,0,0,0,,0,0,0,1
47,213,12,459,1.09,0.46,160,24,30,0.8,10,10,7,134,54,80,110,60,50,0.546,0.559,95,57,38,0.6,15,3,12,0.2,72,37,35,0.514,8,59,59,22
48,208,12,2,-0.8,0,0,0,0,,0,0,0,0,0,0,2,0,2,0,0,0,0,0,,2,0,2,0,0,0,0,,0,0,0,2
49,210,12,261,1.13,0.43,100,17,15,1.13,6,4,1,68,27,41,66,39,27,0.591,0.591,66,39,27,0.591,0,0,0,,42,22,20,0.524,1,25,37,25
50,189,11,38,0.42,0.39,4,2,4,0.5,0,2,1,11,6,5,8,2,6,0.25,0.25,8,2,6,0.25,0,0,0,,0,0,0,,0,0,3,7
51,194,11,309,0.97,0.38,121,15,22,0.68,4,8,9,80,26,54,96,50,46,0.521,0.552,78,44,34,0.564,18,6,12,0.333,32,15,17,0.469,3,21,28,14
52,193,11,3,-0.67,-0.67,0,0,1,0,0,1,0,0,0,0,0,0,0,,,0,0,0,,0,0,0,,0,0,0,,0,0,1,2
53,183,11,143,0.47,0.22,34,8,12,0.67,4,10,2,22,5,17,38,12,26,0.316,0.421,7,4,3,0.571,31,8,23,0.258,4,2,2,0.5,0,6,6,13
54,191,11,152,0.76,0.23,42,6,8,0.75,2,6,2,26,5,21,29,15,14,0.517,0.552,21,13,8,0.619,8,2,6,0.25,14,10,4,0.714,0,9,6,14
55,185,11,338,1.54,0.51,178,58,53,1.09,40,34,3,67,11,56,137,62,75,0.453,0.464,123,59,64,0.48,14,3,11,0.214,79,51,28,0.646,8,57,28,14
56,179,11,222,0.49,0.09,52,14,13,1.08,2,10,0,13,1,12,48,15,33,0.312,0.417,14,5,9,0.357,34,10,24,0.294,13,12,1,0.923,0,7,13,12
57,180,11,19,0.38,0.26,2,1,1,1,1,1,0,3,0,3,2,1,1,0.5,0.5,1,1,0,1,1,0,1,0,0,0,0,,0,1,0,5
58,186,11,1,-0.9,0,0,0,0,,0,0,0,0,0,0,1,0,1,0,0,1,0,1,0,0,0,0,,0,0,0,,0,0,0,1
59,190,11,153,0.46,0.08,48,4,10,0.4,4,7,1,14,0,14,48,17,31,0.354,0.458,18,7,11,0.389,30,10,20,0.333,8,4,4,0.5,0,6,9,12
60,192,11,291,1.71,0.44,179,4,19,0.21,10,7,9,97,24,73,109,65,44,0.596,0.596,109,65,44,0.596,0,0,0,,74,49,25,0.662,9,61,44,14
61,195,11,4,0.74,0,1,0,0,,0,0,0,0,0,0,1,0,1,0,0,1,0,1,0,0,0,0,,2,1,1,0.5,0,1,0,2
62,187,11,16,1.43,0.19,15,1,2,0.5,2,2,0,1,0,1,12,5,7,0.417,0.583,1,1,0,1,11,4,7,0.364,2,1,1,0.5,0,1,0,5
63,184,11,25,0.29,0.24,5,0,0,,1,0,0,3,1,2,9,2,7,0.222,0.278,3,1,2,0.333,6,1,5,0.167,1,0,1,0,1,1,1,3
64,188,11,156,0.38,0.24,27,7,13,0.54,6,8,5,20,7,13,49,9,40,0.184,0.214,29,6,23,0.207,20,3,17,0.15,11,6,5,0.546,1,11,21,14
65,181,11,270,0.81,0.29,74,14,18,0.78,10,13,0,56,9,47,61,25,36,0.41,0.443,45,21,24,0.467,16,4,12,0.25,26,20,6,0.769,1,20,16,14
66,178,11,217,0.67,0.16,71,19,21,0.9,7,13,0,23,2,21,60,21,39,0.35,0.483,17,5,12,0.294,43,16,27,0.372,22,13,9,0.591,2,21,16,14
67,182,11,42,0.87,0.24,21,1,1,1,1,1,0,5,3,2,15,7,8,0.467,0.667,3,1,2,0.333,12,6,6,0.5,4,1,3,0.25,0,2,4,6
68,49,3,111,0.88,0.15,43,14,15,0.93,3,7,0,12,1,11,34,14,20,0.412,0.471,16,10,6,0.625,18,4,14,0.222,15,11,4,0.733,2,17,14,16
69,52,3,310,0.9,0.31,120,14,25,0.56,14,11,1,65,22,43,102,47,55,0.461,0.505,65,38,27,0.585,37,9,28,0.243,26,17,9,0.654,6,24,28,22
70,47,3,46,0.71,0.26,21,4,3,1.33,0,1,0,8,2,6,24,10,14,0.417,0.438,18,9,9,0.5,6,1,5,0.167,0,0,0,,0,0,4,10
71,56,3,358,0.54,0.27,65,9,32,0.28,11,16,5,85,27,58,80,22,58,0.275,0.294,65,19,46,0.292,15,3,12,0.2,30,18,12,0.6,3,24,53,25
72,48,3,307,0.44,0.22,62,16,19,0.84,11,7,4,31,13,18,77,24,53,0.312,0.357,48,17,31,0.354,29,7,22,0.241,14,7,7,0.5,1,13,37,23
73,51,3,449,0.83,0.24,185,48,45,1.07,32,25,1,35,3,32,159,61,98,0.384,0.513,52,20,32,0.385,107,41,66,0.383,38,22,16,0.579,0,44,51,25
74,54,3,328,0.71,0.3,108,9,14,0.64,13,5,1,74,8,66,110,38,72,0.346,0.45,31,15,16,0.484,79,23,56,0.291,12,9,3,0.75,0,14,47,19
75,50,3,337,0.74,0.18,139,14,24,0.58,8,8,3,39,18,21,133,50,83,0.376,0.455,58,29,29,0.5,75,21,54,0.28,32,18,14,0.562,3,24,33,25
76,44,3,654,1.38,0.48,338,59,56,1.05,47,35,22,145,26,119,248,124,124,0.5,0.56,157,94,63,0.599,91,30,61,0.33,79,60,19,0.759,9,64,64,23
77,57,3,6,0.9,0,4,0,0,,0,0,0,0,0,0,3,2,1,0.667,0.667,2,2,0,1,1,0,1,0,0,0,0,,0,0,1,2
78,46,3,436,0.6,0.22,118,21,15,1.4,11,10,2,41,16,25,115,47,68,0.409,0.439,81,40,41,0.494,34,7,27,0.206,32,17,15,0.531,3,20,26,24
79,53,3,87,0.83,0.54,22,3,5,0.6,3,3,6,28,5,23,25,9,16,0.36,0.4,17,7,10,0.412,8,2,6,0.25,4,2,2,0.5,0,2,12,12
80,45,3,223,0.48,0.17,41,23,19,1.21,6,13,0,15,3,12,33,13,20,0.394,0.515,10,5,5,0.5,23,8,15,0.348,8,7,1,0.875,0,14,18,17
81,55,3,615,1.24,0.28,355,41,47,0.87,7,19,18,110,23,87,327,135,192,0.413,0.428,281,125,156,0.445,46,10,36,0.217,102,75,27,0.735,13,91,37,24
82,1,1,24,0.17,0,6,0,2,0,0,0,0,3,1,2,9,3,6,0.333,0.333,8,3,5,0.375,1,0,1,0,0,0,0,,0,0,2,2
83,9,1,12,2.4,1.75,6,2,1,2,2,1,0,10,5,5,7,2,5,0.286,0.286,7,2,5,0.286,0,0,0,,6,2,4,0.333,0,3,8,5
84,12,1,100,1.01,0.47,41,13,15,0.87,9,10,0,23,10,13,44,15,29,0.341,0.398,14,10,4,0.714,30,5,25,0.167,12,6,6,0.5,1,9,14,12
86,21,1,158,1.06,0.45,65,2,15,0.13,10,3,4,50,19,31,64,25,39,0.391,0.398,60,24,36,0.4,4,1,3,0.25,31,14,17,0.452,1,24,24,13
87,5,1,385,1.02,0.34,187,32,46,0.7,18,24,9,85,18,67,189,67,122,0.354,0.423,92,41,51,0.446,97,26,71,0.268,34,27,7,0.794,2,24,30,15
88,2,1,165,1.08,0.01,106,13,36,0.36,7,17,0,26,8,18,92,35,57,0.38,0.44,56,24,32,0.429,36,11,25,0.306,45,25,20,0.556,1,21,21,15
90,19,1,73,1.62,0.63,48,7,10,0.7,5,3,4,25,9,16,54,17,37,0.315,0.324,44,16,28,0.364,10,1,9,0.1,26,13,13,0.5,2,14,24,12
91,18,1,128,0.69,0.09,45,11,21,0.52,4,17,1,18,3,15,40,13,27,0.325,0.425,17,5,12,0.294,23,8,15,0.348,16,11,5,0.688,2,17,20,13
92,23,1,33,1.5,0.33,27,1,5,0.2,2,4,0,10,5,5,26,12,14,0.462,0.462,26,12,14,0.462,0,0,0,,3,3,0,1,1,4,6,4
93,8,1,36,0.65,0.47,7,2,2,1,2,1,0,10,3,7,14,2,12,0.143,0.143,13,2,11,0.154,1,0,1,0,7,3,4,0.429,0,4,8,4
94,6,1,300,1.44,0.58,142,9,21,0.43,12,8,13,101,48,53,107,53,54,0.495,0.5,104,52,52,0.5,3,1,2,0.333,64,35,29,0.547,10,47,48,15
95,4,1,342,1.44,0.42,193,45,39,1.15,23,17,2,72,11,61,150,64,86,0.427,0.503,82,41,41,0.5,68,23,45,0.338,54,42,12,0.778,8,41,49,16
96,16,1,59,0.83,0.34,15,3,4,0.75,2,3,2,11,3,8,15,5,10,0.333,0.333,9,5,4,0.556,6,0,6,0,7,5,2,0.714,0,4,16,12
97,22,1,16,0.76,0.81,4,1,3,0.33,0,4,2,10,3,7,8,2,6,0.25,0.25,8,2,6,0.25,0,0,0,,2,0,2,0,0,2,20,9
98,13,1,67,1.06,0.46,27,4,8,0.5,4,2,2,19,8,11,28,11,17,0.393,0.393,24,11,13,0.458,4,0,4,0,8,5,3,0.625,0,9,31,11
99,3,1,318,1.36,0.18,223,32,52,0.62,16,20,2,43,18,25,211,73,138,0.346,0.405,121,48,73,0.397,90,25,65,0.278,70,52,18,0.743,6,59,44,14
100,20,1,28,1.22,0.46,6,1,1,1,1,0,2,5,2,3,4,0,4,0,0,4,0,4,0,0,0,0,,10,6,4,0.6,0,6,6,2
101,169,10,65,0.6,0.34,13,4,5,0.8,3,1,0,13,5,8,16,5,11,0.312,0.312,16,5,11,0.312,0,0,0,,6,3,3,0.5,0,3,13,6
102,166,10,10,0.47,0,3,0,1,0,0,1,0,1,1,0,1,1,0,1,1.5,0,0,0,,1,1,0,1,0,0,0,,0,0,2,5
103,167,10,336,1.06,0.45,125,34,29,1.17,7,13,14,76,23,53,89,52,37,0.584,0.601,82,49,33,0.598,7,3,4,0.429,31,18,13,0.581,3,24,38,16
104,158,10,64,0.29,0.31,1,6,4,1.5,6,4,0,4,0,4,6,0,6,0,0,5,0,5,0,1,0,1,0,2,1,1,0.5,0,2,9,7
105,170,10,73,0.46,0.1,24,2,8,0.25,0,2,2,11,4,7,29,10,19,0.345,0.379,23,8,15,0.348,6,2,4,0.333,2,2,0,1,0,1,11,5
106,164,10,10,0.73,-0.2,6,1,3,0.33,0,1,0,1,1,0,2,2,0,1,1.5,0,0,0,,2,2,0,1,0,0,0,,0,0,2,4
107,173,10,114,0.73,0.32,30,6,11,0.55,3,4,1,31,8,23,26,12,14,0.462,0.481,22,11,11,0.5,4,1,3,0.25,10,5,5,0.5,0,10,18,11
108,168,10,383,0.8,0.23,109,35,39,0.9,11,22,2,52,19,33,83,38,45,0.458,0.47,72,36,36,0.5,11,2,9,0.182,41,31,10,0.756,5,31,49,16
109,161,10,372,1.03,0.21,159,15,28,0.54,7,17,4,60,21,39,120,52,68,0.433,0.496,66,37,29,0.561,54,15,39,0.278,51,40,11,0.784,6,34,27,16
110,160,10,17,-0.48,-0.71,1,0,7,0,0,5,0,2,0,2,0,0,0,,,0,0,0,,0,0,0,,2,1,1,0.5,0,2,2,3
111,175,10,496,1.29,0.32,288,76,50,1.52,14,22,0,59,20,39,240,107,133,0.446,0.485,181,88,93,0.486,59,19,40,0.322,78,55,23,0.705,7,53,27,16
112,174,10,53,0.59,0.45,10,6,4,1.5,2,1,1,11,3,8,13,5,8,0.385,0.385,13,5,8,0.385,0,0,0,,1,0,1,0,0,2,10,8
113,171,10,4,2.95,1.25,2,0,0,,2,0,0,1,0,1,1,0,1,0,0,1,0,1,0,0,0,0,,4,2,2,0.5,0,2,0,1
114,165,10,333,1.18,0.29,196,28,42,0.67,18,26,0,76,11,65,145,72,73,0.497,0.603,86,41,45,0.477,59,31,28,0.525,31,21,10,0.677,5,28,20,12
115,159,10,63,0.52,0.25,17,6,4,1.5,2,2,0,7,1,6,18,6,12,0.333,0.472,2,1,1,0.5,16,5,11,0.312,0,0,0,,0,2,4,8
116,163,10,244,1.27,0.56,98,27,23,1.17,6,14,11,77,18,59,75,38,37,0.507,0.527,68,35,33,0.515,7,3,4,0.429,26,19,7,0.731,1,17,30,14
117,172,10,270,0.81,0.16,115,16,20,0.8,5,9,1,31,7,24,84,41,43,0.488,0.613,31,20,11,0.645,53,21,32,0.396,17,12,5,0.706,0,9,22,16
118,162,10,289,1.39,0.33,147,22,20,1.1,8,9,0,57,17,40,80,46,34,0.575,0.669,45,31,14,0.689,35,15,20,0.429,58,40,18,0.69,11,42,30,16
119,153,9,122,0.67,0.11,35,5,10,0.5,1,1,1,14,6,8,28,10,18,0.357,0.411,22,7,15,0.318,6,3,3,0.5,22,12,10,0.546,1,16,29,12
120,140,9,56,0.21,0.05,12,5,10,0.5,1,6,0,10,1,9,15,5,10,0.333,0.4,12,3,9,0.25,3,2,1,0.667,1,0,1,0,1,3,6,11
121,139,9,505,0.73,0.29,138,22,29,0.76,13,16,5,103,21,82,119,52,67,0.437,0.492,71,39,32,0.549,48,13,35,0.271,23,21,2,0.913,1,18,33,17
122,148,9,150,0.91,0.17,60,8,13,0.62,3,9,0,21,9,12,43,17,26,0.395,0.546,15,4,11,0.267,28,13,15,0.464,14,13,1,0.929,0,11,20,16
123,141,9,17,0.59,0.59,0,2,0,,2,0,0,2,0,2,0,0,0,,,0,0,0,,0,0,0,,0,0,0,,0,0,1,8
124,145,9,466,0.58,0.2,171,31,28,1.11,15,16,0,49,6,43,182,64,118,0.352,0.451,78,28,50,0.359,104,36,68,0.346,16,7,9,0.438,1,15,21,17
125,146,9,405,0.68,0.26,125,40,34,1.18,20,14,3,43,5,38,119,47,72,0.395,0.462,71,31,40,0.437,48,16,32,0.333,27,15,12,0.556,2,26,48,17
126,155,9,74,0.54,0.18,19,3,4,0.75,2,2,0,10,1,9,17,7,10,0.412,0.5,9,4,5,0.444,8,3,5,0.375,2,2,0,1,0,1,12,10
127,147,9,105,0.84,0.32,39,4,8,0.5,7,3,1,20,6,14,33,18,15,0.546,0.546,33,18,15,0.546,0,0,0,,5,3,2,0.6,1,5,18,9
128,143,9,119,0.22,0.11,8,6,8,0.75,3,4,1,7,2,5,10,2,8,0.2,0.25,6,1,5,0.167,4,1,3,0.25,5,3,2,0.6,1,4,12,14
129,142,9,101,0.94,0.29,37,6,5,1.2,2,3,0,17,6,11,21,16,5,0.762,0.762,21,16,5,0.762,0,0,0,,8,5,3,0.625,2,5,13,9
130,144,9,214,0.71,0.21,79,27,16,1.69,7,10,0,7,1,6,76,25,51,0.329,0.447,27,7,20,0.259,49,18,31,0.367,18,11,7,0.611,1,18,13,11
131,151,9,39,0.77,0.13,19,2,3,0.67,0,1,0,6,1,5,12,8,4,0.667,0.792,8,5,3,0.625,4,3,1,0.75,1,0,1,0,1,1,1,10
132,154,9,21,0.54,0.29,4,2,1,2,0,0,0,2,2,0,3,2,1,0.667,0.667,2,2,0,1,1,0,1,0,0,0,0,,0,0,3,10
133,150,9,472,0.84,0.13,205,22,54,0.41,21,30,4,55,19,36,176,80,96,0.454,0.48,148,71,77,0.48,28,9,19,0.321,48,36,12,0.75,7,58,34,17
134,156,9,385,0.73,0.35,92,15,29,0.52,4,13,7,98,42,56,83,35,48,0.422,0.44,73,32,41,0.438,10,3,7,0.3,34,19,15,0.559,1,23,38,17
135,152,9,21,0.11,0.05,4,0,0,,0,0,0,1,0,1,4,2,2,0.5,0.5,3,2,1,0.667,1,0,1,0,4,0,4,0,0,2,1,10
136,149,9,153,0.33,0.14,21,14,13,1.08,3,7,0,12,2,10,18,8,10,0.444,0.5,11,6,5,0.546,7,2,5,0.286,9,3,6,0.333,1,8,9,15
137,60,4,1,-0.5,-1,2,0,1,0,0,0,0,1,0,1,4,1,3,0.25,0.25,3,1,2,0.333,1,0,1,0,0,0,0,,0,0,1,3
138,67,4,104,0.88,0.43,49,24,21,1.14,6,14,0,22,5,17,49,18,31,0.367,0.5,23,5,18,0.217,26,13,13,0.5,4,0,4,0,0,3,8,5
139,68,4,75,0.51,0.27,18,2,4,0.5,4,4,0,13,3,10,15,7,8,0.467,0.6,7,3,4,0.429,8,4,4,0.5,4,0,4,0,0,3,4,4
140,66,4,7,0.29,0.29,0,2,2,1,0,1,0,2,0,2,0,0,0,,,0,0,0,,0,0,0,,0,0,0,,0,0,0,4
141,63,4,49,0.59,0.29,17,2,5,0.4,4,2,0,8,4,4,18,7,11,0.389,0.472,12,4,8,0.333,6,3,3,0.5,2,0,2,0,0,2,4,5
142,71,4,55,0.91,0.35,19,6,7,0.86,0,2,2,13,4,9,18,7,11,0.389,0.417,16,6,10,0.375,2,1,1,0.5,5,4,1,0.8,1,4,12,4
143,64,4,30,0.1,0,11,4,6,0.67,0,4,0,3,1,2,21,4,17,0.19,0.262,6,1,5,0.167,15,3,12,0.2,0,0,0,,0,1,3,4
144,70,4,102,1.72,0.27,88,8,20,0.4,3,12,6,30,4,26,74,29,45,0.392,0.48,44,16,28,0.364,30,13,17,0.433,21,17,4,0.81,0,16,15,5
145,61,4,23,2.41,1.26,12,1,2,0.5,3,0,5,11,4,7,9,4,5,0.444,0.444,9,4,5,0.444,0,0,0,,4,4,0,1,0,3,5,3
146,59,4,47,1.57,0.55,27,6,9,0.67,9,4,4,6,0,6,23,9,14,0.391,0.391,22,9,13,0.409,1,0,1,0,21,9,12,0.429,1,16,8,5
147,62,4,105,0.92,0.21,62,10,10,1,2,6,1,15,1,14,61,22,39,0.361,0.475,24,8,16,0.333,37,14,23,0.378,5,4,1,0.8,1,5,12,5
148,69,4,1,1,1,0,0,0,,0,0,0,1,0,1,0,0,0,,,0,0,0,,0,0,0,,0,0,0,,0,0,0,3
149,65,4,1,-2,-2,0,0,1,0,0,1,0,0,0,0,0,0,0,,,0,0,0,,0,0,0,,0,0,0,,0,0,0,3
150,41,2,10,0.62,0.4,2,0,0,,1,0,1,0,0,0,2,1,1,0.5,0.5,2,1,1,0.5,0,0,0,,0,0,0,,0,0,2,4
151,29,2,178,0.93,0.17,68,8,15,0.53,3,8,2,30,5,25,48,23,25,0.479,0.521,35,19,16,0.543,13,4,9,0.308,25,18,7,0.72,3,18,27,23
152,30,2,285,0.52,0.15,60,20,27,0.74,5,12,0,35,13,22,48,23,25,0.479,0.49,39,22,17,0.564,9,1,8,0.111,22,13,9,0.591,3,20,31,26
153,34,2,22,-0.05,-0.32,5,0,4,0,0,2,0,1,0,1,7,2,5,0.286,0.286,3,2,1,0.667,4,0,4,0,2,1,1,0.5,0,4,5,11
154,26,2,7,1.44,0.57,3,1,0,,0,0,0,2,0,2,2,1,1,0.5,0.5,2,1,1,0.5,0,0,0,,2,1,1,0.5,0,1,0,5
155,35,2,433,0.57,0.1,119,22,32,0.69,5,12,0,41,13,28,92,41,51,0.446,0.533,45,25,20,0.556,47,16,31,0.34,25,21,4,0.84,1,20,40,26
156,37,2,543,1.26,0.53,199,41,23,1.78,13,14,15,160,38,122,137,72,65,0.526,0.544,116,67,49,0.578,21,5,16,0.238,64,50,14,0.781,5,53,34,26
157,27,2,739,1.33,0.45,324,129,69,1.87,27,44,5,112,37,75,247,103,144,0.417,0.458,168,83,85,0.494,79,20,59,0.253,139,98,41,0.705,5,102,40,26
158,31,2,52,0.93,0.38,14,11,9,1.22,6,7,0,4,0,4,11,4,7,0.364,0.409,6,3,3,0.5,5,1,4,0.2,9,5,4,0.556,0,4,3,10
159,42,2,3,1.77,0,4,0,1,0,0,0,0,1,1,0,3,2,1,0.667,0.667,3,2,1,0.667,0,0,0,,0,0,0,,0,0,0,3
160,28,2,107,0.52,0.4,13,9,10,0.9,9,3,0,22,5,17,21,5,16,0.238,0.262,14,4,10,0.286,7,1,6,0.143,2,2,0,1,0,4,20,19
161,32,2,740,1.1,0.26,418,30,22,1.36,15,7,3,122,15,107,335,142,193,0.424,0.552,114,56,58,0.491,221,86,135,0.389,62,48,14,0.774,7,62,30,26
162,38,2,6,-1,-1,0,0,4,0,0,2,0,1,1,0,0,0,0,,,0,0,0,,0,0,0,,0,0,0,,0,0,2,4
163,33,2,617,0.51,0.17,121,27,34,0.79,20,14,1,67,10,57,90,40,50,0.444,0.539,45,23,22,0.511,45,17,28,0.378,39,24,15,0.615,2,32,46,26
164,36,2,302,0.94,0.37,123,33,51,0.65,18,19,14,73,12,61,116,51,65,0.44,0.47,86,44,42,0.512,30,7,23,0.233,23,14,9,0.609,5,25,70,24
165,40,2,712,1.07,0.38,270,39,46,0.85,23,22,24,146,44,102,186,109,77,0.586,0.586,186,109,77,0.586,0,0,0,,78,52,26,0.667,6,74,45,26
166,39,2,295,1.03,0.3,147,2,9,0.22,5,5,11,55,15,40,133,63,70,0.474,0.485,126,60,66,0.476,7,3,4,0.429,24,18,6,0.75,3,19,35,26
167,99,6,867,0.99,0.34,305,58,57,1.02,21,19,11,179,54,125,224,110,114,0.491,0.527,179,94,85,0.525,45,16,29,0.356,105,69,36,0.657,7,75,93,33
168,96,6,105,0.48,0.16,22,2,10,0.2,0,2,1,23,8,15,20,9,11,0.45,0.45,19,9,10,0.474,1,0,1,0,8,4,4,0.5,2,7,17,13
169,89,6,793,0.76,0.21,294,39,42,0.93,23,24,2,104,15,89,250,95,155,0.38,0.51,84,30,54,0.357,166,65,101,0.392,52,39,13,0.75,2,35,56,33
170,101,6,390,1.02,0.26,189,14,38,0.37,13,8,19,74,11,63,125,74,51,0.592,0.688,80,50,30,0.625,45,24,21,0.533,23,17,6,0.739,4,26,67,30
171,98,6,785,0.83,0.33,252,58,35,1.66,38,22,5,100,26,74,210,85,125,0.405,0.509,91,41,50,0.451,119,44,75,0.37,53,38,15,0.717,2,44,45,33
172,100,6,618,0.59,0.19,201,35,32,1.09,19,16,1,65,8,57,164,69,95,0.421,0.601,20,10,10,0.5,144,59,85,0.41,5,4,1,0.8,0,16,45,33
173,92,6,906,1.77,0.47,549,174,81,2.15,43,34,2,124,24,100,355,173,182,0.487,0.542,259,134,125,0.517,96,39,57,0.406,187,164,23,0.877,12,150,64,32
174,90,6,93,0.73,0.33,30,8,7,1.14,7,5,2,10,1,9,30,12,18,0.4,0.467,17,8,9,0.471,13,4,9,0.308,3,2,1,0.667,0,4,12,12
175,97,6,417,1.41,0.64,183,23,42,0.55,31,15,18,158,47,111,122,74,48,0.607,0.607,122,74,48,0.607,0,0,0,,70,35,35,0.5,6,55,69,21
176,91,6,453,0.92,0.31,177,46,40,1.15,11,17,11,75,10,65,150,64,86,0.427,0.503,74,41,33,0.554,76,23,53,0.303,36,26,10,0.722,7,33,33,33
177,95,6,771,0.66,0.23,176,62,31,2,16,19,1,68,11,57,134,54,80,0.403,0.481,76,33,43,0.434,58,21,37,0.362,70,47,23,0.671,2,57,60,33
178,93,6,3,0.77,0,2,0,1,0,1,0,0,0,0,0,1,1,0,1,1,1,1,0,1,0,0,0,,1,0,1,0,1,1,0,1
179,94,6,24,0.45,0.04,9,1,3,0.33,0,2,1,2,1,1,9,4,5,0.444,0.5,5,3,2,0.6,4,1,3,0.25,0,0,0,,0,1,3,6
180,136,8,715,0.95,0.26,252,31,50,0.62,15,24,16,127,33,94,196,83,113,0.424,0.469,141,65,76,0.461,55,18,37,0.327,81,68,13,0.84,10,79,65,26
181,128,8,133,0.85,0.37,44,8,7,1.14,3,5,0,35,6,29,38,16,22,0.421,0.513,17,9,8,0.529,21,7,14,0.333,6,5,1,0.833,0,5,8,8
182,125,8,2,-1.4,-1,0,0,1,0,0,1,0,0,0,0,1,0,1,0,0,0,0,0,,1,0,1,0,0,0,0,,0,0,2,2
183,127,8,600,0.6,0.19,183,30,21,1.43,9,18,3,60,10,50,207,57,150,0.275,0.365,82,20,62,0.244,125,37,88,0.296,40,32,8,0.8,0,26,27,24
184,137,8,181,0.72,0.35,50,4,6,0.67,0,0,3,49,12,37,42,23,19,0.548,0.548,42,23,19,0.548,0,0,0,,10,4,6,0.4,3,8,31,15
185,120,8,742,0.65,0.06,288,35,60,0.58,8,32,1,63,14,49,275,96,179,0.349,0.434,145,49,96,0.338,130,47,83,0.362,62,49,13,0.79,3,44,31,24
186,135,8,172,0.33,0.21,17,1,8,0.12,0,5,4,30,12,18,18,7,11,0.389,0.389,18,7,11,0.389,0,0,0,,9,3,6,0.333,0,9,18,16
187,126,8,97,0.73,0.2,28,1,4,0.25,5,1,0,11,4,7,20,8,12,0.4,0.55,4,2,2,0.5,16,6,10,0.375,7,6,1,0.857,0,4,6,18
188,134,8,633,1.32,0.52,288,27,35,0.77,6,13,19,223,73,150,206,120,86,0.582,0.582,206,120,86,0.582,0,0,0,,64,48,16,0.75,11,55,78,26
189,124,8,934,1.39,0.21,473,83,71,1.17,16,40,1,123,11,112,288,119,169,0.413,0.514,158,61,97,0.386,130,58,72,0.446,217,177,40,0.816,16,158,43,26
190,133,8,437,0.74,0.46,91,14,20,0.7,8,9,10,132,47,85,87,40,47,0.46,0.46,86,40,46,0.465,1,0,1,0,26,11,15,0.423,3,24,43,24
191,131,8,5,-0.18,0,0,0,0,,0,0,0,0,0,0,1,0,1,0,0,1,0,1,0,0,0,0,,0,0,0,,0,0,0,2
192,121,8,1,4.65,0,3,0,0,,0,0,0,0,0,0,1,1,0,1,1.5,0,0,0,,1,1,0,1,0,0,0,,0,0,0,1
193,132,8,28,0.79,0.39,6,1,2,0.5,0,1,2,5,4,1,5,2,3,0.4,0.4,5,2,3,0.4,0,0,0,,4,2,2,0.5,0,3,5,7
194,130,8,450,0.46,0.2,106,16,21,0.76,10,12,4,61,12,49,109,41,68,0.376,0.468,48,21,27,0.438,61,20,41,0.328,7,4,3,0.571,0,10,37,19
195,129,8,125,0.62,0.32,26,4,4,1,1,1,2,28,6,22,20,9,11,0.45,0.575,9,4,5,0.444,11,5,6,0.454,7,3,4,0.429,1,4,7,13
196,123,8,26,0.56,0.15,3,3,2,1.5,0,1,0,2,0,2,3,0,3,0,0,1,0,1,0,2,0,2,0,4,3,1,0.75,0,2,1,6
197,122,8,19,0.11,0.32,0,1,0,,2,0,0,0,0,0,5,0,5,0,0,0,0,0,,5,0,5,0,0,0,0,,0,1,0,4
198,73,5,900,1.7,0.3,712,115,96,1.2,37,38,6,124,18,106,539,224,315,0.416,0.528,208,103,105,0.495,331,121,210,0.366,174,143,31,0.822,8,120,43,26
199,79,5,155,0.89,0.52,33,9,2,4.5,5,1,2,39,14,25,19,14,5,0.737,0.737,19,14,5,0.737,0,0,0,,11,5,6,0.454,3,8,30,22
200,87,5,10,0.72,0.2,5,0,0,,0,0,0,1,1,0,5,2,3,0.4,0.5,3,1,2,0.333,2,1,1,0.5,0,0,0,,0,0,0,3
201,82,5,11,1.12,0.64,4,2,1,2,0,1,0,3,2,1,3,2,1,0.667,0.667,3,2,1,0.667,0,0,0,,0,0,0,,0,0,1,3
202,81,5,508,0.97,0.45,146,22,19,1.16,6,4,34,112,31,81,117,49,68,0.419,0.483,56,34,22,0.607,61,15,46,0.246,45,33,12,0.733,3,29,85,26
203,74,5,620,1.37,0.42,320,35,35,1,16,12,6,167,47,120,211,115,96,0.545,0.595,152,94,58,0.618,59,21,38,0.356,114,69,45,0.605,13,82,68,26
204,85,5,821,0.79,0.46,164,114,55,2.07,30,32,16,129,37,92,128,61,67,0.477,0.488,117,58,59,0.496,11,3,8,0.273,89,39,50,0.438,3,75,71,26
205,84,5,22,0.83,0.36,14,2,1,2,0,1,0,5,1,4,20,6,14,0.3,0.35,6,4,2,0.667,14,2,12,0.143,0,0,0,,0,0,2,9
206,83,5,30,0.77,0.47,9,1,1,1,2,1,0,8,2,6,9,4,5,0.444,0.5,4,3,1,0.75,5,1,4,0.2,1,0,1,0,1,1,2,8
207,80,5,838,1.04,0.19,407,24,27,0.89,19,8,1,98,28,70,268,142,126,0.53,0.64,152,83,69,0.546,116,59,57,0.509,72,64,8,0.889,4,54,30,26
208,86,5,347,0.86,0.27,119,10,21,0.48,5,7,6,67,26,41,94,42,52,0.447,0.505,48,31,17,0.646,46,11,35,0.239,35,24,11,0.686,3,28,63,24
209,75,5,427,0.83,0.34,112,14,18,0.78,7,9,20,74,26,48,73,45,28,0.616,0.616,73,45,28,0.616,0,0,0,,32,22,10,0.688,4,24,45,24
210,77,5,63,1.03,0.37,18,5,6,0.83,4,0,2,12,1,11,7,5,2,0.714,0.857,3,3,0,1,4,2,2,0.5,10,6,4,0.6,0,10,5,14
211,78,5,440,0.54,0.28,67,63,32,1.97,7,17,4,33,6,27,50,22,28,0.44,0.55,19,11,8,0.579,31,11,20,0.355,17,12,5,0.706,0,20,39,26
212,76,5,59,0.65,0.31,12,5,4,1.25,1,3,1,9,3,6,11,3,8,0.273,0.409,2,0,2,0,9,3,6,0.333,4,3,1,0.75,0,2,6,11
213,275,16,16,0.44,0.25,2,0,0,,0,0,0,4,0,4,1,1,0,1,1,1,1,0,1,0,0,0,,0,0,0,,0,0,1,2
214,282,16,239,0.33,0.05,48,3,24,0.12,6,16,2,31,7,24,40,16,24,0.4,0.538,14,5,9,0.357,26,11,15,0.423,8,5,3,0.625,0,7,44,25
215,280,16,634,1.01,0.28,270,36,44,0.82,33,16,3,113,11,102,209,88,121,0.421,0.522,96,46,50,0.479,113,42,71,0.372,70,52,18,0.743,4,51,60,25
216,276,16,261,0.7,0.32,39,24,26,0.92,8,12,3,46,19,27,25,10,15,0.4,0.4,21,10,11,0.476,4,0,4,0,27,19,8,0.704,0,18,18,22
217,281,16,97,0.7,0.21,30,9,8,1.12,4,4,1,8,0,8,31,10,21,0.323,0.387,13,6,7,0.462,18,4,14,0.222,6,6,0,1,0,5,7,17
218,279,16,36,0.05,0.06,2,2,5,0.4,0,3,0,7,1,6,5,1,4,0.2,0.2,3,1,2,0.333,2,0,2,0,0,0,0,,0,0,3,13
219,284,16,550,0.53,0.12,149,39,42,0.93,9,22,3,41,9,32,128,54,74,0.422,0.508,64,32,32,0.5,64,22,42,0.344,26,19,7,0.731,6,21,45,25
220,278,16,177,0.51,-0.01,67,12,27,0.44,6,17,0,14,2,12,71,25,46,0.352,0.394,54,19,35,0.352,17,6,11,0.353,18,11,7,0.611,1,16,20,16
221,272,16,339,0.77,0.23,118,18,21,0.86,3,11,6,55,12,43,108,45,63,0.417,0.454,77,37,40,0.48,31,8,23,0.258,31,20,11,0.645,4,17,15,13
222,287,16,688,1.11,0.21,316,23,65,0.35,15,31,18,120,41,79,185,122,63,0.66,0.66,185,122,63,0.66,0,0,0,,119,72,47,0.605,9,108,78,25
223,283,16,218,0.39,0.15,30,10,17,0.59,2,9,4,30,4,26,23,10,13,0.435,0.522,12,6,6,0.5,11,4,7,0.364,8,6,2,0.75,0,9,12,16
224,274,16,124,0.65,0.03,38,7,20,0.35,7,10,0,15,1,14,37,10,27,0.27,0.324,25,6,19,0.24,12,4,8,0.333,17,14,3,0.824,0,13,13,12
225,286,16,240,0.56,0.2,62,9,22,0.41,4,6,4,47,12,35,55,28,27,0.509,0.518,50,27,23,0.54,5,1,4,0.2,7,5,2,0.714,1,5,39,23
226,288,16,13,0.93,0.23,4,0,1,0,0,0,1,2,1,1,2,1,1,0.5,0.5,2,1,1,0.5,0,0,0,,5,2,3,0.4,1,3,0,6
227,277,16,523,0.83,0.15,190,22,65,0.34,16,25,8,95,24,71,150,63,87,0.42,0.473,101,47,54,0.465,49,16,33,0.326,67,48,19,0.716,8,45,59,25
228,273,16,755,0.73,0.3,238,80,63,1.27,36,34,0,105,16,89,234,92,142,0.393,0.444,154,68,86,0.442,80,24,56,0.3,47,30,17,0.638,4,36,72,25
229,285,16,89,0.36,0.15,19,1,7,0.14,0,3,2,15,6,9,22,7,15,0.318,0.364,15,5,10,0.333,7,2,5,0.286,11,3,8,0.273,1,8,17,16
230,317,18,391,0.58,0.27,79,22,26,0.85,16,16,8,52,13,39,66,29,37,0.439,0.508,40,20,20,0.5,26,9,17,0.346,19,12,7,0.632,0,19,38,26
231,319,18,158,0.56,0.13,52,9,8,1.12,2,5,0,11,4,7,48,18,30,0.375,0.49,19,7,12,0.368,29,11,18,0.379,9,5,4,0.556,1,9,17,20
232,328,18,755,0.84,0.21,287,53,45,1.18,13,25,3,93,20,73,235,104,131,0.443,0.504,149,75,74,0.503,86,29,57,0.337,68,50,18,0.735,9,55,40,26
233,322,18,22,0.97,0.23,5,0,3,0,1,2,0,7,2,5,8,0,8,0,0,5,0,5,0,3,0,3,0,5,5,0,1,0,4,2,4
234,316,18,897,1.16,0.2,519,54,52,1.04,33,28,0,86,19,67,439,172,267,0.392,0.481,216,94,122,0.435,223,78,145,0.35,118,97,21,0.822,13,107,46,26
235,331,18,191,0.71,0.24,77,8,16,0.5,8,8,1,31,12,19,83,36,47,0.434,0.434,77,36,41,0.468,6,0,6,0,8,5,3,0.625,0,9,28,20
236,325,18,36,0.61,0.39,8,5,0,,1,1,0,1,1,0,9,4,5,0.444,0.444,8,4,4,0.5,1,0,1,0,0,0,0,,0,1,4,9
237,313,18,531,0.48,0.3,79,54,32,1.69,20,12,2,56,16,40,81,27,54,0.333,0.457,14,7,7,0.5,67,20,47,0.298,6,5,1,0.833,0,11,31,25
238,320,18,65,0.47,0.4,6,1,2,0.5,1,0,3,19,1,18,10,2,8,0.2,0.25,2,1,1,0.5,8,1,7,0.125,3,1,2,0.333,0,2,7,11
239,321,18,238,0.62,0.14,84,6,19,0.32,5,5,3,36,8,28,73,30,43,0.411,0.514,35,15,20,0.429,38,15,23,0.395,18,9,9,0.5,2,11,37,23
240,323,18,26,0.08,-0.04,4,0,2,0,0,1,0,3,0,3,6,2,4,0.333,0.333,2,2,0,1,4,0,4,0,0,0,0,,0,0,1,4
241,333,18,6,-0.12,0.33,0,0,0,,0,0,0,2,0,2,3,0,3,0,0,3,0,3,0,0,0,0,,0,0,0,,0,0,0,1
242,314,18,112,0.6,0.16,30,4,8,0.5,10,3,0,6,0,6,27,10,17,0.37,0.444,11,6,5,0.546,16,4,12,0.25,8,6,2,0.75,0,3,10,8
243,332,18,12,0.64,-0.5,7,0,3,0,0,0,0,0,0,0,6,2,4,0.333,0.417,3,1,2,0.333,3,1,2,0.333,2,2,0,1,0,1,5,3
244,324,18,252,0.78,0.59,42,19,9,2.11,7,3,13,71,18,53,52,18,34,0.346,0.365,35,16,19,0.457,17,2,15,0.118,5,4,1,0.8,2,9,31,13
245,312,18,656,0.77,0.33,199,57,42,1.36,10,28,13,118,20,98,159,66,93,0.415,0.563,45,19,26,0.422,114,47,67,0.412,23,20,3,0.87,0,18,49,25
246,318,18,65,0.16,0,14,5,10,0.5,2,7,0,5,1,4,21,5,16,0.238,0.286,7,3,4,0.429,14,2,12,0.143,7,2,5,0.286,1,6,8,10
247,329,18,8,0.27,0.13,1,0,1,0,0,0,0,2,1,1,3,0,3,0,0,3,0,3,0,0,0,0,,2,1,1,0.5,0,1,4,2
248,330,18,211,0.29,0.17,35,5,5,1,1,4,3,23,4,19,44,13,31,0.296,0.398,11,4,7,0.364,33,9,24,0.273,2,0,2,0,0,1,17,22
249,311,18,188,0.59,0.23,44,13,10,1.3,7,4,1,13,9,4,47,15,32,0.319,0.372,23,10,13,0.435,24,5,19,0.208,13,9,4,0.692,3,14,21,16
250,327,18,366,0.49,0.2,85,12,17,0.71,6,4,1,54,15,39,77,33,44,0.429,0.513,45,20,25,0.444,32,13,19,0.406,13,6,7,0.462,0,11,36,23
251,234,14,451,0.68,0.22,129,27,31,0.87,17,6,1,60,13,47,95,46,49,0.484,0.584,53,27,26,0.509,42,19,23,0.452,26,18,8,0.692,1,21,37,29
252,241,14,838,0.93,0.31,296,64,35,1.83,32,19,4,107,22,85,215,99,116,0.461,0.558,118,57,61,0.483,97,42,55,0.433,72,56,16,0.778,9,60,62,29
253,248,14,736,0.92,0.42,229,30,32,0.94,11,9,33,173,49,124,169,96,73,0.568,0.595,147,87,60,0.592,22,9,13,0.409,40,28,12,0.7,6,31,62,29
254,249,14,22,0.68,0.23,5,1,2,0.5,1,0,0,4,1,3,6,1,5,0.167,0.25,0,0,0,,6,1,5,0.167,2,2,0,1,0,1,6,10
255,243,14,154,0.91,0.36,48,13,9,1.44,5,5,2,28,6,22,38,15,23,0.395,0.5,16,7,9,0.438,22,8,14,0.364,13,10,3,0.769,0,12,13,21
256,246,14,65,0.34,0.22,9,2,4,0.5,4,4,0,9,1,8,10,4,6,0.4,0.45,5,3,2,0.6,5,1,4,0.2,1,0,1,0,0,1,7,15
257,247,14,134,0.71,0.24,38,5,14,0.36,4,7,3,29,7,22,34,14,20,0.412,0.441,23,12,11,0.522,11,2,9,0.182,12,8,4,0.667,0,12,25,21
258,233,14,43,0.38,0.26,5,2,1,2,1,1,0,6,1,5,11,1,10,0.091,0.136,6,0,6,0,5,1,4,0.2,2,2,0,1,0,1,5,13
259,252,14,22,1.02,0.41,7,1,1,1,2,1,0,4,1,3,6,2,4,0.333,0.417,4,1,3,0.25,2,1,1,0.5,2,2,0,1,0,1,3,11
260,242,14,53,0.87,0.11,25,4,6,0.67,1,3,0,7,1,6,21,9,12,0.429,0.5,14,6,8,0.429,7,3,4,0.429,5,4,1,0.8,0,3,4,15
261,235,14,601,0.8,0.24,186,36,29,1.24,18,12,5,67,20,47,133,62,71,0.466,0.564,70,36,34,0.514,63,26,37,0.413,44,36,8,0.818,3,47,68,28
262,244,14,30,0.66,0.43,3,3,4,0.75,2,2,0,7,4,3,1,1,0,1,1,1,1,0,1,0,0,0,,2,1,1,0.5,0,1,4,11
263,245,14,158,1.06,0.24,60,8,15,0.53,3,5,4,33,5,28,35,18,17,0.514,0.6,21,12,9,0.571,14,6,8,0.429,24,18,6,0.75,3,19,37,19
265,251,14,28,0.78,0.54,6,2,2,1,0,1,3,6,3,3,4,3,1,0.75,0.75,4,3,1,0.75,0,0,0,,2,0,2,0,0,1,2,11
266,236,14,596,1.35,0.3,295,48,44,1.09,28,17,3,94,12,82,192,90,102,0.469,0.534,131,65,66,0.496,61,25,36,0.41,116,90,26,0.776,6,81,59,29
267,239,14,783,1.38,0.34,458,63,52,1.21,37,28,10,132,21,111,328,170,158,0.518,0.573,238,134,104,0.563,90,36,54,0.4,105,82,23,0.781,12,95,63,29
268,240,14,32,1.51,0.06,29,4,5,0.8,0,4,0,4,0,4,14,12,2,0.857,1,9,8,1,0.889,5,4,1,0.8,1,1,0,1,1,1,2,14
269,263,15,213,0.59,0.12,96,8,14,0.57,10,10,0,13,4,9,100,33,67,0.33,0.465,15,6,9,0.4,85,27,58,0.318,7,3,4,0.429,0,3,10,25
270,270,15,307,0.77,0.44,65,9,9,1,12,7,4,70,34,36,56,28,28,0.5,0.5,55,28,27,0.509,1,0,1,0,14,9,5,0.643,2,11,62,28
271,268,15,365,0.84,0.39,81,6,18,0.33,10,8,11,82,41,41,48,30,18,0.625,0.625,48,30,18,0.625,0,0,0,,34,21,13,0.618,1,21,71,28
272,262,15,29,0.27,0.34,2,1,1,1,2,2,0,5,1,4,7,1,6,0.143,0.143,7,1,6,0.143,0,0,0,,0,0,0,,0,1,2,7
273,257,15,423,0.91,0.22,158,15,17,0.88,11,6,8,46,12,34,122,50,72,0.41,0.5,54,28,26,0.518,68,22,46,0.324,41,36,5,0.878,0,30,29,28
274,260,15,56,0.06,0.02,12,6,10,0.6,1,8,0,7,0,7,24,4,20,0.167,0.25,3,0,3,0,21,4,17,0.19,0,0,0,,0,1,3,17
275,255,15,327,0.66,0.3,74,18,20,0.9,20,10,1,44,17,27,68,30,38,0.441,0.448,59,29,30,0.492,9,1,8,0.111,20,13,7,0.65,1,22,46,24
276,267,15,717,0.94,0.24,316,20,31,0.65,26,13,5,107,28,79,265,109,156,0.411,0.502,122,61,61,0.5,143,48,95,0.336,69,50,19,0.725,1,44,54,28
277,269,15,128,0.66,0.46,15,6,4,1.5,7,0,1,29,10,19,14,5,9,0.357,0.393,10,4,6,0.4,4,1,3,0.25,7,4,3,0.571,0,6,26,19
278,258,15,992,1.77,0.45,723,39,75,0.52,51,34,14,297,91,206,555,274,281,0.494,0.514,476,252,224,0.529,79,22,57,0.278,196,153,43,0.781,26,154,69,29
279,266,15,651,0.58,0.33,101,32,14,2.29,29,9,1,91,27,64,103,30,73,0.291,0.379,33,12,21,0.364,70,18,52,0.257,30,23,7,0.767,0,23,71,27
280,254,15,20,-0.29,-0.2,0,3,7,0.43,1,7,0,2,0,2,2,0,2,0,0,2,0,2,0,0,0,0,,0,0,0,,0,3,2,5
281,259,15,61,0.39,0.3,6,2,10,0.2,3,5,1,16,10,6,13,2,11,0.154,0.154,10,2,8,0.2,3,0,3,0,2,2,0,1,0,1,12,8
282,264,15,77,0.27,0.1,11,2,5,0.4,2,5,0,7,3,4,12,4,8,0.333,0.417,3,2,1,0.667,9,2,7,0.222,2,1,1,0.5,0,1,9,18
283,265,15,321,0.77,0.48,50,5,17,0.29,9,6,26,71,36,35,42,18,24,0.429,0.429,42,18,24,0.429,0,0,0,,20,14,6,0.7,1,11,58,23
284,296,17,675,1,0.22,319,42,35,1.2,13,14,4,88,15,73,243,112,131,0.461,0.554,137,67,70,0.489,106,45,61,0.424,65,50,15,0.769,7,45,29,27
285,291,17,8,0.62,0.75,2,0,0,,1,0,0,3,1,2,6,1,5,0.167,0.167,2,1,1,0.5,4,0,4,0,0,0,0,,0,0,0,3
286,303,17,345,0.67,0.18,116,8,26,0.31,3,9,5,60,21,39,91,48,43,0.528,0.566,77,41,36,0.532,14,7,7,0.5,26,13,13,0.5,5,28,24,26
287,292,17,172,0.32,0.27,17,8,16,0.5,8,5,6,23,11,12,26,7,19,0.269,0.269,25,7,18,0.28,1,0,1,0,14,3,11,0.214,2,13,30,24
288,306,17,665,1.14,0.33,279,22,32,0.69,6,12,29,132,37,95,176,107,69,0.608,0.625,159,101,58,0.635,17,6,11,0.353,82,59,23,0.72,7,62,50,27
289,299,17,14,0.54,0.5,2,1,0,,0,0,0,3,2,1,4,1,3,0.25,0.25,3,1,2,0.333,1,0,1,0,0,0,0,,0,1,1,6
290,304,17,108,0.79,0.28,29,3,5,0.6,2,2,4,15,7,8,17,11,6,0.647,0.647,17,11,6,0.647,0,0,0,,15,7,8,0.467,2,11,17,22
291,298,17,241,0.49,0.18,39,28,17,1.65,3,11,0,15,0,15,26,12,14,0.462,0.577,10,6,4,0.6,16,6,10,0.375,10,9,1,0.9,0,9,15,25
292,302,17,173,1.46,0.4,95,4,16,0.25,7,9,8,48,16,32,58,37,21,0.638,0.647,51,36,15,0.706,7,1,6,0.143,30,20,10,0.667,7,23,17,11
293,294,17,328,0.7,0.19,76,21,20,1.05,7,10,2,35,8,27,46,22,24,0.478,0.576,25,13,12,0.52,21,9,12,0.429,27,23,4,0.852,2,22,27,26
294,300,17,545,0.78,0.31,165,18,19,0.95,11,7,1,111,37,74,127,60,67,0.472,0.575,65,34,31,0.523,62,26,36,0.419,25,19,6,0.76,3,26,60,27
295,301,17,413,1.19,0.06,263,23,38,0.61,7,18,1,36,4,32,197,82,115,0.416,0.541,83,33,50,0.398,114,49,65,0.43,52,50,2,0.962,3,43,34,27
296,293,17,660,0.68,0.29,153,57,25,2.28,15,7,2,73,18,55,129,47,82,0.364,0.473,50,19,31,0.38,79,28,51,0.354,39,31,8,0.795,2,30,52,27
297,308,17,14,1.33,0.57,4,1,1,1,0,0,0,6,2,4,3,1,2,0.333,0.333,3,1,2,0.333,0,0,0,,2,2,0,1,0,1,1,4
298,290,17,78,1.27,0.38,33,7,4,1.75,1,2,2,14,4,10,22,11,11,0.5,0.5,18,11,7,0.611,4,0,4,0,19,11,8,0.579,2,14,14,20
299,338,19,641,0.44,0.3,60,58,25,2.32,21,13,2,58,22,36,67,22,45,0.328,0.358,41,18,23,0.439,26,4,22,0.154,18,12,6,0.667,0,13,31,24
300,350,19,246,0.89,0.33,92,16,15,1.07,9,7,2,39,18,21,73,39,34,0.534,0.555,63,36,27,0.571,10,3,7,0.3,22,11,11,0.5,4,18,30,19
301,341,19,210,0.52,0.27,43,9,11,0.82,11,7,0,31,7,24,35,15,20,0.429,0.6,9,3,6,0.333,26,12,14,0.462,2,1,1,0.5,0,9,18,19
302,340,19,194,0.67,0.34,52,9,10,0.9,9,6,2,35,11,24,59,21,38,0.356,0.373,43,19,24,0.442,16,2,14,0.125,18,8,10,0.444,4,12,23,21
303,349,19,626,1.02,0.42,243,48,27,1.78,23,19,4,122,43,79,189,108,81,0.571,0.577,176,106,70,0.602,13,2,11,0.154,31,25,6,0.806,4,38,67,24
304,337,19,531,1.3,0.48,262,70,58,1.21,27,25,10,133,23,110,187,103,84,0.551,0.604,135,83,52,0.615,52,20,32,0.385,45,36,9,0.8,5,38,59,23
305,352,19,5,0.02,0.2,0,0,0,,0,0,0,1,0,1,1,0,1,0,0,1,0,1,0,0,0,0,,0,0,0,,0,0,1,3
306,353,19,80,1.35,0.51,39,5,1,5,1,0,1,22,7,15,29,14,15,0.483,0.552,24,10,14,0.417,5,4,1,0.8,9,7,2,0.778,1,8,7,13
307,343,19,721,1.09,0.18,341,25,44,0.57,12,20,7,112,16,96,245,111,134,0.453,0.524,137,76,61,0.555,108,35,73,0.324,104,84,20,0.808,14,72,33,24
308,335,19,145,0.34,0.17,21,13,8,1.62,1,4,0,11,2,9,19,9,10,0.474,0.526,14,7,7,0.5,5,2,3,0.4,4,1,3,0.25,0,4,10,17
309,348,19,149,0.44,0.19,37,9,12,0.75,1,3,1,25,5,20,43,17,26,0.395,0.407,40,16,24,0.4,3,1,2,0.333,5,2,3,0.4,1,7,16,16
310,342,19,399,0.63,0.24,99,31,25,1.24,14,12,1,48,7,41,87,34,53,0.391,0.46,56,22,34,0.393,31,12,19,0.387,33,19,14,0.576,1,26,28,24
311,346,19,515,0.67,0.17,202,32,41,0.78,14,18,5,52,16,36,206,81,125,0.393,0.447,136,59,77,0.434,70,22,48,0.314,22,18,4,0.818,1,29,47,24
312,336,19,332,0.62,0.07,127,28,37,0.76,7,15,0,21,5,16,112,43,69,0.384,0.496,34,18,16,0.529,78,25,53,0.32,25,16,9,0.64,3,22,26,21
313,356,20,528,1.05,0.31,224,64,44,1.45,27,28,8,48,8,40,190,84,106,0.442,0.461,161,77,84,0.478,29,7,22,0.241,69,49,20,0.71,8,61,32,15
314,363,20,39,0.55,0.44,7,5,3,1.67,2,2,1,4,3,1,12,2,10,0.167,0.25,7,0,7,0,5,2,3,0.4,2,1,1,0.5,0,1,5,10
315,366,20,11,-0.26,0.18,0,1,0,,0,0,0,0,0,0,6,0,6,0,0,1,0,1,0,5,0,5,0,0,0,0,,0,0,0,5
316,361,20,182,0.37,0.15,38,7,10,0.7,4,6,1,17,7,10,47,15,32,0.319,0.372,22,10,12,0.454,25,5,20,0.2,5,3,2,0.6,0,6,13,18
317,362,20,263,0.63,0.35,59,9,12,0.75,14,9,3,48,16,32,68,25,43,0.368,0.375,58,24,34,0.414,10,1,9,0.1,13,8,5,0.615,0,12,33,17
318,364,20,643,1.11,0.49,249,12,43,0.28,27,20,12,208,92,116,217,101,116,0.465,0.468,207,100,107,0.483,10,1,9,0.1,77,46,31,0.597,7,59,38,19
319,359,20,351,0.65,0.15,125,23,25,0.92,11,10,0,29,5,24,94,42,52,0.447,0.622,21,9,12,0.429,73,33,40,0.452,9,8,1,0.889,1,6,27,19
320,360,20,12,-0.23,-0.08,0,1,2,0.5,0,1,0,1,0,1,2,0,2,0,0,2,0,2,0,0,0,0,,0,0,0,,0,0,0,4
321,368,20,173,0.47,0.27,19,4,9,0.44,2,2,4,30,14,16,17,7,10,0.412,0.412,16,7,9,0.438,1,0,1,0,7,5,2,0.714,0,7,38,19
322,357,20,532,1.11,0.22,235,51,43,1.19,11,25,2,66,8,58,192,66,126,0.344,0.422,93,36,57,0.387,99,30,69,0.303,87,73,14,0.839,7,58,29,16
323,365,20,511,1.36,0.59,218,23,54,0.43,18,17,38,189,65,124,162,83,79,0.512,0.512,161,83,78,0.516,1,0,1,0,96,52,44,0.542,8,86,72,19
324,367,20,540,0.51,0.2,113,22,14,1.57,14,12,2,51,10,41,93,37,56,0.398,0.532,28,12,16,0.429,65,25,40,0.385,21,14,7,0.667,1,18,17,19
325,358,20,66,0.45,0.18,10,1,2,0.5,3,0,0,7,1,6,10,3,7,0.3,0.35,7,2,5,0.286,3,1,2,0.333,4,3,1,0.75,0,3,8,12
326,377,21,26,0.06,0.19,2,0,0,,0,0,0,5,0,5,9,1,8,0.111,0.111,3,1,2,0.333,6,0,6,0,0,0,0,,0,2,5,6
327,375,21,16,0.73,-0.13,9,0,1,0,0,1,0,0,0,0,6,4,2,0.667,0.667,5,4,1,0.8,1,0,1,0,3,1,2,0.333,0,1,0,3
328,372,21,395,0.58,0.36,64,65,33,1.97,9,14,0,54,7,47,64,22,42,0.344,0.414,40,13,27,0.325,24,9,15,0.375,24,11,13,0.458,3,24,31,14
329,385,21,100,0.46,0.32,18,3,7,0.43,4,2,6,16,4,12,26,8,18,0.308,0.308,24,8,16,0.333,2,0,2,0,7,2,5,0.286,0,4,14,18
330,373,21,580,0.82,0.32,149,33,28,1.18,22,14,3,104,22,82,93,52,41,0.559,0.608,75,43,32,0.573,18,9,9,0.5,54,36,18,0.667,7,37,49,25
331,370,21,16,0.2,-0.13,5,1,5,0.2,2,2,0,2,0,2,5,2,3,0.4,0.5,2,1,1,0.5,3,1,2,0.333,0,0,0,,0,0,2,4
332,380,21,16,1.29,1,3,3,0,,3,0,0,3,1,2,1,1,0,1,1.5,0,0,0,,1,1,0,1,0,0,0,,0,0,2,6
333,374,21,129,0.76,0.43,30,11,6,1.83,6,1,1,24,8,16,32,12,20,0.375,0.391,23,11,12,0.478,9,1,8,0.111,8,5,3,0.625,2,8,11,12
334,371,21,798,0.71,0.25,285,73,37,1.97,19,23,6,68,10,58,252,105,147,0.417,0.532,89,47,42,0.528,163,58,105,0.356,20,17,3,0.85,2,13,44,25
335,376,21,444,0.53,0.27,86,31,32,0.97,11,13,0,80,18,62,80,36,44,0.45,0.475,60,32,28,0.533,20,4,16,0.2,19,10,9,0.526,1,20,35,17
336,378,21,566,1.38,0.55,283,13,37,0.35,13,17,37,190,69,121,223,118,105,0.529,0.529,221,118,103,0.534,2,0,2,0,70,47,23,0.671,3,55,81,25
337,384,21,664,1.91,0.34,517,37,52,0.71,13,24,17,158,37,121,378,187,191,0.495,0.495,376,187,189,0.497,2,0,2,0,184,143,41,0.777,14,138,29,25
338,379,21,362,0.44,0.2,51,28,20,1.4,8,9,0,37,2,35,50,19,31,0.38,0.38,40,19,21,0.475,10,0,10,0,20,13,7,0.65,3,21,27,23
339,383,21,15,0.29,0,4,0,4,0,0,2,0,5,3,2,4,2,2,0.5,0.5,4,2,2,0.5,0,0,0,,0,0,0,,0,0,2,5
340,369,21,805,0.9,0.24,371,87,63,1.38,29,35,1,78,5,73,292,131,161,0.449,0.582,115,53,62,0.461,177,78,99,0.441,35,31,4,0.886,1,37,65,25
341,381,21,2,0,0,0,0,1,0,0,0,0,1,1,0,0,0,0,,,0,0,0,,0,0,0,,0,0,0,,0,0,2,1
342,382,21,151,0.65,0.27,35,3,9,0.33,2,3,3,33,10,23,22,16,6,0.727,0.727,22,16,6,0.727,0,0,0,,4,3,1,0.75,0,3,15,16
343,394,22,450,0.71,0.26,119,21,28,0.75,20,8,3,63,23,40,95,45,50,0.474,0.51,73,38,35,0.52,22,7,15,0.318,33,22,11,0.667,3,22,39,30
344,398,22,65,0.72,0.37,16,3,3,1,0,2,4,10,6,4,14,7,7,0.5,0.5,14,7,7,0.5,0,0,0,,4,2,2,0.5,0,3,11,12
345,401,22,17,0.96,0,7,1,3,0.33,1,3,0,2,0,2,2,2,0,1,1.25,1,1,0,1,1,1,0,1,3,2,1,0.667,1,2,1,9
346,386,22,752,0.83,0.24,287,47,48,0.98,24,22,8,87,30,57,226,119,107,0.526,0.558,189,105,84,0.556,37,14,23,0.378,51,35,16,0.686,11,38,60,28
347,392,22,991,1.29,0.18,659,54,66,0.82,28,29,5,122,13,109,516,243,273,0.471,0.531,333,181,152,0.544,183,62,121,0.339,145,111,34,0.766,15,120,52,32
348,388,22,673,0.6,0.27,137,26,32,0.81,21,14,5,112,31,81,119,48,71,0.403,0.471,71,32,39,0.451,48,16,32,0.333,34,25,9,0.735,0,26,66,32
349,395,22,13,0.75,0.15,6,1,1,1,0,1,0,2,0,2,4,2,2,0.5,0.75,0,0,0,,4,2,2,0.5,0,0,0,,0,0,2,5
350,391,22,820,0.68,0.3,189,59,32,1.84,41,16,3,88,13,75,149,67,82,0.45,0.52,96,46,50,0.479,53,21,32,0.396,54,34,20,0.63,3,42,44,32
351,390,22,685,0.81,0.26,184,17,58,0.29,21,21,7,150,57,93,154,61,93,0.396,0.396,153,61,92,0.399,1,0,1,0,89,62,27,0.697,9,65,105,32
352,400,22,923,1.21,0.27,456,23,41,0.56,28,17,7,173,42,131,367,157,210,0.428,0.463,277,131,146,0.473,90,26,64,0.289,138,116,22,0.841,15,112,84,32
353,393,22,531,0.7,0.31,130,18,32,0.56,17,15,10,102,36,66,116,48,68,0.414,0.448,83,40,43,0.482,33,8,25,0.242,43,26,17,0.605,1,28,70,32
354,399,22,184,0.72,0.28,50,3,10,0.3,7,3,3,35,11,24,34,22,12,0.647,0.647,33,22,11,0.667,1,0,1,0,12,6,6,0.5,1,12,30,27
355,396,22,210,0.63,0.26,50,15,5,3,4,1,2,17,5,12,38,17,21,0.447,0.579,9,7,2,0.778,29,10,19,0.345,8,6,2,0.75,0,4,21,24
356,408,23,152,0.86,0.16,47,4,11,0.36,3,4,1,27,4,23,29,15,14,0.517,0.517,28,15,13,0.536,1,0,1,0,27,17,10,0.63,2,16,15,23
357,413,23,216,0.97,0.43,63,33,24,1.38,11,7,4,31,14,17,39,26,13,0.667,0.667,39,26,13,0.667,0,0,0,,16,11,5,0.688,1,13,35,20
358,406,23,181,0.75,0.18,60,11,16,0.69,6,9,0,26,4,22,60,20,40,0.333,0.367,32,16,16,0.5,28,4,24,0.143,23,16,7,0.696,2,18,8,6
359,415,23,342,1.39,0.39,152,15,13,1.15,17,8,0,76,21,55,93,51,42,0.548,0.548,93,51,42,0.548,0,0,0,,66,50,16,0.758,5,39,22,25
360,411,23,66,0.38,0.15,8,1,4,0.25,3,2,0,10,0,10,6,2,4,0.333,0.5,0,0,0,,6,2,4,0.333,2,2,0,1,0,1,7,16
361,410,23,717,1.14,0.39,302,111,87,1.28,28,40,5,135,32,103,238,116,122,0.487,0.502,212,109,103,0.514,26,7,19,0.269,89,63,26,0.708,7,86,68,25
362,412,23,49,0.57,0.27,10,1,1,1,0,0,0,10,3,7,11,3,8,0.273,0.364,4,1,3,0.25,7,2,5,0.286,2,2,0,1,0,1,2,9
363,402,23,43,0.31,0.21,5,3,1,3,2,1,0,1,0,1,9,2,7,0.222,0.222,4,2,2,0.5,5,0,5,0,2,1,1,0.5,0,1,2,8
364,421,23,527,0.65,0.25,122,17,18,0.94,13,3,1,80,24,56,90,43,47,0.478,0.539,63,32,31,0.508,27,11,16,0.407,44,25,19,0.568,5,39,59,25
365,407,23,51,0.27,0.14,6,3,2,1.5,0,0,0,4,1,3,8,2,6,0.25,0.312,3,1,2,0.333,5,1,4,0.2,2,1,1,0.5,0,1,1,14
366,403,23,568,0.79,0.2,176,21,17,1.24,22,3,4,42,10,32,99,54,45,0.546,0.717,32,20,12,0.625,67,34,33,0.507,38,34,4,0.895,3,28,71,25
367,416,23,309,0.78,0.2,122,16,26,0.62,9,13,2,50,11,39,101,52,49,0.515,0.525,91,50,41,0.55,10,2,8,0.2,36,16,20,0.444,2,30,38,19
368,405,23,238,0.7,0.2,70,18,21,0.86,11,10,2,23,4,19,49,26,23,0.531,0.612,27,18,9,0.667,22,8,14,0.364,11,10,1,0.909,1,10,16,22
369,409,23,660,0.81,0.23,270,24,21,1.14,12,12,3,92,23,69,237,92,145,0.388,0.508,79,35,44,0.443,158,57,101,0.361,36,29,7,0.806,5,25,35,25
370,404,23,355,0.7,0.16,124,10,10,1,7,5,0,38,5,33,90,42,48,0.467,0.611,34,16,18,0.471,56,26,30,0.464,17,14,3,0.824,1,14,34,24
371,420,23,16,0.13,-0.19,3,1,3,0.33,0,0,0,1,0,1,3,1,2,0.333,0.333,3,1,2,0.333,0,0,0,,2,1,1,0.5,0,1,5,5
372,423,23,502,1.12,0.21,244,24,46,0.52,13,13,15,75,20,55,184,91,93,0.495,0.511,163,85,78,0.522,21,6,15,0.286,73,56,17,0.767,11,61,59,25
373,424,24,845,1.4,0.3,565,134,89,1.51,26,37,3,93,14,79,458,197,261,0.43,0.511,246,123,123,0.5,212,74,138,0.349,126,97,29,0.77,11,140,63,26
374,427,24,15,0.72,0.27,2,0,0,,0,0,0,4,0,4,1,0,1,0,0,1,0,1,0,0,0,0,,4,2,2,0.5,0,2,2,3
375,438,24,105,0.22,0.11,12,5,6,0.83,1,2,0,9,3,6,13,5,8,0.385,0.462,6,3,3,0.5,7,2,5,0.286,1,0,1,0,0,1,10,18
376,443,24,611,1.29,0.5,286,23,34,0.68,7,12,33,189,56,133,198,123,75,0.621,0.626,188,121,67,0.644,10,2,8,0.2,52,38,14,0.731,11,40,87,26
377,430,24,20,0.77,0.15,6,1,4,0.25,3,3,0,3,0,3,5,2,3,0.4,0.4,2,2,0,1,3,0,3,0,3,2,1,0.667,0,2,3,7
378,442,24,210,0.65,0.38,38,5,5,1,5,3,6,44,14,30,39,15,24,0.385,0.397,34,14,20,0.412,5,1,4,0.2,11,7,4,0.636,1,12,40,25
379,431,24,198,0.72,0.27,38,4,11,0.36,4,3,6,34,13,21,23,12,11,0.522,0.522,23,12,11,0.522,0,0,0,,18,14,4,0.778,3,16,25,11
380,440,24,602,1.65,0.45,404,31,31,1,6,21,11,197,40,157,280,141,139,0.504,0.589,162,93,69,0.574,118,48,70,0.407,96,74,22,0.771,11,70,55,26
381,433,24,29,0.56,0.31,8,1,3,0.33,0,0,1,8,3,5,7,4,3,0.571,0.571,7,4,3,0.571,0,0,0,,3,0,3,0,0,3,3,11
382,441,24,673,0.68,0.23,171,56,38,1.47,24,22,0,61,11,50,122,53,69,0.434,0.57,52,20,32,0.385,70,33,37,0.471,39,32,7,0.82,2,25,39,26
383,436,24,795,1.11,0.44,278,89,66,1.35,31,38,35,146,24,122,203,93,110,0.458,0.51,135,72,63,0.533,68,21,47,0.309,102,71,31,0.696,9,89,46,26
384,444,24,25,1.35,0.96,9,2,2,1,0,1,2,14,6,8,9,3,6,0.333,0.444,2,1,1,0.5,7,2,5,0.286,4,1,3,0.25,0,2,4,10
385,426,24,7,0.46,0.14,2,0,0,,0,1,0,1,0,1,2,1,1,0.5,0.5,2,1,1,0.5,0,0,0,,0,0,0,,0,1,0,8
386,432,24,18,0.63,-0.06,4,0,1,0,0,1,0,1,0,1,1,1,0,1,1,1,1,0,1,0,0,0,,2,2,0,1,0,1,1,1
387,429,24,129,0.51,0.22,20,11,7,1.57,2,5,1,12,3,9,21,5,16,0.238,0.31,3,2,1,0.667,18,3,15,0.167,10,7,3,0.7,0,9,19,20
388,435,24,4,1.53,0.75,2,0,0,,0,0,1,1,0,1,1,1,0,1,1,1,1,0,1,0,0,0,,0,0,0,,0,0,0,4
389,439,24,530,0.65,0.27,133,22,10,2.2,10,3,2,68,28,40,113,50,63,0.442,0.518,66,33,33,0.5,47,17,30,0.362,17,16,1,0.941,3,15,32,26
390,453,25,40,0.99,0.48,11,3,0,,2,0,0,7,2,5,9,3,6,0.333,0.444,3,1,2,0.333,6,2,4,0.333,4,3,1,0.75,0,2,6,4
391,455,25,26,0.29,0,8,0,1,0,1,1,0,0,0,0,9,3,6,0.333,0.444,1,1,0,1,8,2,6,0.25,0,0,0,,0,0,1,6
392,454,25,4,3.13,1,2,1,0,,0,0,0,2,0,2,0,0,0,,,0,0,0,,0,0,0,,3,2,1,0.667,0,2,0,3
393,452,25,86,0.36,0.16,15,4,7,0.57,2,3,2,10,2,8,15,5,10,0.333,0.467,1,1,0,1,14,4,10,0.286,3,1,2,0.333,0,2,9,21
394,446,25,110,0.76,0.35,38,9,14,0.64,15,10,1,14,3,11,35,19,16,0.543,0.543,33,19,14,0.576,2,0,2,0,0,0,0,,0,1,14,18
395,464,25,124,0.72,0.34,38,8,5,1.6,2,3,5,16,6,10,38,13,25,0.342,0.461,9,4,5,0.444,29,9,20,0.31,4,3,1,0.75,0,2,14,17
396,459,25,29,0.49,0.48,4,1,3,0.33,1,1,0,10,6,4,7,2,5,0.286,0.286,7,2,5,0.286,0,0,0,,2,0,2,0,0,2,9,9
397,460,25,28,0.27,0.11,6,0,2,0,0,0,0,5,2,3,8,2,6,0.25,0.375,0,0,0,,8,2,6,0.25,0,0,0,,0,1,3,11
398,450,25,67,0.29,0.24,11,3,4,0.75,1,1,0,12,4,8,21,5,16,0.238,0.262,11,4,7,0.364,10,1,9,0.1,0,0,0,,0,1,7,15
399,465,25,382,0.57,0.19,112,7,19,0.37,12,7,6,53,8,45,107,42,65,0.392,0.467,58,26,32,0.448,49,16,33,0.326,25,12,13,0.48,3,23,64,26
400,451,25,978,1.49,0.41,603,93,77,1.21,52,34,7,211,40,171,458,232,226,0.506,0.537,343,204,139,0.595,115,28,87,0.243,150,111,39,0.74,14,120,85,29
401,448,25,982,1.11,0.51,333,153,35,4.37,36,14,11,139,29,110,245,125,120,0.51,0.551,193,105,88,0.544,52,20,32,0.385,82,63,19,0.768,8,58,41,29
402,447,25,959,1.09,0.26,467,39,59,0.66,14,21,7,206,39,167,348,168,180,0.483,0.556,200,117,83,0.585,148,51,97,0.345,110,80,30,0.727,15,80,81,29
403,461,25,41,1.11,0.39,14,4,2,2,0,1,1,7,3,4,11,4,7,0.364,0.364,9,4,5,0.444,2,0,2,0,12,6,6,0.5,0,6,3,14
404,449,25,213,0.47,0.15,54,3,9,0.33,3,4,1,26,9,17,66,17,49,0.258,0.341,22,6,16,0.273,44,11,33,0.25,12,9,3,0.75,0,7,13,22
405,458,25,569,0.65,0.15,182,21,27,0.78,18,14,1,54,8,46,154,59,95,0.383,0.506,37,21,16,0.568,117,38,79,0.325,32,26,6,0.812,1,18,62,29
406,456,25,123,1.14,0.43,57,6,6,1,11,3,2,20,7,13,45,21,24,0.467,0.533,29,15,14,0.517,16,6,10,0.375,19,9,10,0.474,1,14,18,9
407,462,25,140,0.58,0.29,30,2,14,0.14,1,5,6,40,10,30,28,13,15,0.464,0.464,28,13,15,0.464,0,0,0,,9,4,5,0.444,3,10,30,21
408,457,25,937,1.17,0.34,420,60,25,2.4,25,6,9,140,42,98,284,132,152,0.465,0.584,117,64,53,0.547,167,68,99,0.407,111,88,23,0.793,6,72,56,29
409,489,26,10,0.13,0.4,0,0,1,0,0,1,0,4,2,2,3,0,3,0,0,3,0,3,0,0,0,0,,0,0,0,,0,1,2,3
410,470,26,11,0.33,0.27,2,2,1,2,0,0,0,1,0,1,4,1,3,0.25,0.25,2,1,1,0.5,2,0,2,0,0,0,0,,0,0,1,2
411,485,26,78,0.86,0.36,28,1,10,0.1,0,2,5,28,8,20,24,13,11,0.542,0.542,24,13,11,0.542,0,0,0,,3,2,1,0.667,1,3,15,15
412,473,26,664,1.07,0.23,355,44,33,1.33,7,24,3,102,12,90,320,124,196,0.388,0.466,167,74,93,0.443,153,50,103,0.327,67,57,10,0.851,5,56,41,24
413,484,26,13,0.71,0.38,5,0,2,0,1,0,0,4,3,1,6,2,4,0.333,0.417,4,1,3,0.25,2,1,1,0.5,0,0,0,,0,1,5,4
414,469,26,87,0.98,0.26,35,7,12,0.58,5,5,1,15,6,9,31,12,19,0.387,0.419,23,10,13,0.435,8,2,6,0.25,13,9,4,0.692,4,13,13,20
415,468,26,14,0.45,-0.07,5,0,3,0,1,3,0,3,0,3,6,2,4,0.333,0.333,6,2,4,0.333,0,0,0,,1,1,0,1,1,1,0,9
416,475,26,26,0.57,0.65,4,3,0,,3,0,0,5,0,5,11,2,9,0.182,0.182,5,2,3,0.4,6,0,6,0,1,0,1,0,0,1,4,9
417,486,26,580,0.93,0.46,187,27,18,1.5,20,9,21,131,38,93,168,67,101,0.399,0.479,87,40,47,0.46,81,27,54,0.333,41,26,15,0.634,5,27,64,26
418,480,26,399,0.9,0.32,152,17,12,1.42,12,10,6,68,15,53,122,56,66,0.459,0.545,59,35,24,0.593,63,21,42,0.333,31,19,12,0.613,4,25,51,23
419,487,26,46,0.43,0.37,2,0,0,,0,0,3,9,2,7,8,0,8,0,0,1,0,1,0,7,0,7,0,2,2,0,1,0,1,4,14
420,471,26,107,0.92,0.48,30,14,4,3.5,3,2,2,16,5,11,33,9,24,0.273,0.348,14,4,10,0.286,19,5,14,0.263,8,7,1,0.875,0,6,11,14
421,481,26,518,1.16,0.44,224,35,43,0.81,21,19,21,132,27,105,174,84,90,0.483,0.534,117,66,51,0.564,57,18,39,0.316,53,38,15,0.717,6,44,59,22
422,478,26,33,0.83,0.48,9,3,2,1.5,1,2,0,7,5,2,7,4,3,0.571,0.643,5,3,2,0.6,2,1,1,0.5,0,0,0,,0,1,3,11
423,477,26,11,-0.26,-0.09,3,0,1,0,0,1,0,1,0,1,9,1,8,0.111,0.167,1,0,1,0,8,1,7,0.125,0,0,0,,0,0,0,4
424,474,26,819,1.17,0.41,390,103,31,3.32,39,20,2,86,24,62,305,151,154,0.495,0.554,216,115,101,0.532,89,36,53,0.404,68,52,16,0.765,7,68,50,26
425,488,26,14,0.81,0.5,4,1,0,,1,0,0,2,1,1,4,2,2,0.5,0.5,4,2,2,0.5,0,0,0,,0,0,0,,0,0,2,10
426,483,26,21,0.89,0.62,6,0,0,,0,0,1,9,2,7,7,3,4,0.429,0.429,7,3,4,0.429,0,0,0,,0,0,0,,0,1,6,11
427,472,26,714,0.95,0.33,320,20,45,0.44,19,20,8,172,63,109,296,133,163,0.449,0.486,235,111,124,0.472,61,22,39,0.361,50,32,18,0.64,9,53,66,26
428,482,26,283,0.52,0.2,74,8,17,0.47,10,12,2,33,17,16,76,27,49,0.355,0.447,27,13,14,0.482,49,14,35,0.286,7,6,1,0.857,0,7,12,25
429,479,26,694,0.99,0.43,267,71,35,2.03,32,21,16,102,26,76,236,95,141,0.402,0.496,118,51,67,0.432,118,44,74,0.373,44,33,11,0.75,7,45,70,26
430,500,27,695,1.09,0.46,276,33,50,0.66,15,21,41,188,55,133,199,123,76,0.618,0.618,199,123,76,0.618,0,0,0,,52,30,22,0.577,6,41,54,27
431,499,27,289,1.04,0.29,127,12,16,0.75,2,5,8,53,19,34,95,53,42,0.558,0.558,95,53,42,0.558,0,0,0,,29,21,8,0.724,2,24,37,27
432,494,27,254,1.18,0.3,109,6,27,0.22,15,9,8,56,16,40,70,39,31,0.557,0.557,70,39,31,0.557,0,0,0,,48,31,17,0.646,4,36,41,26
433,492,27,369,0.6,0.35,67,39,17,2.29,15,9,3,44,4,40,65,28,37,0.431,0.446,51,26,25,0.51,14,2,12,0.143,15,9,6,0.6,2,10,20,26
434,505,27,33,1.49,0.39,19,0,1,0,1,0,1,8,3,5,11,8,3,0.727,0.727,10,8,2,0.8,1,0,1,0,3,3,0,1,1,2,6,9
435,493,27,634,1.13,0.45,257,82,30,2.73,33,17,2,97,13,84,193,83,110,0.43,0.56,62,33,29,0.532,131,50,81,0.382,45,41,4,0.911,6,42,29,24
436,496,27,12,1.36,0.42,7,0,2,0,1,2,0,5,2,3,5,3,2,0.6,0.6,5,3,2,0.6,0,0,0,,2,1,1,0.5,0,1,3,7
437,503,27,72,0.85,0.46,16,4,4,1,5,2,2,13,6,7,13,6,7,0.462,0.5,8,5,3,0.625,5,1,4,0.2,3,3,0,1,1,3,10,15
438,501,27,667,1.32,0.27,407,42,62,0.68,13,23,14,147,21,126,310,145,165,0.468,0.544,193,98,95,0.508,117,47,70,0.402,80,70,10,0.875,7,73,58,27
439,491,27,14,0.94,0.5,5,4,2,2,0,2,0,3,0,3,4,2,2,0.5,0.625,1,1,0,1,3,1,2,0.333,0,0,0,,0,0,1,7
440,506,27,572,0.73,0.2,190,41,59,0.69,20,23,4,83,20,63,181,65,116,0.359,0.425,97,41,56,0.423,84,24,60,0.286,45,36,9,0.8,4,36,68,27
441,507,27,753,1.31,0.21,455,50,68,0.74,28,42,1,120,19,101,346,153,193,0.442,0.517,205,101,104,0.493,141,52,89,0.369,115,97,18,0.844,9,83,66,27
442,502,27,6,0.38,0.67,0,1,0,,1,0,0,0,0,0,2,0,2,0,0,1,0,1,0,1,0,1,0,0,0,0,,0,0,1,3
443,498,27,201,0.46,0.19,33,12,13,0.92,7,4,1,19,5,14,29,11,18,0.379,0.466,14,6,8,0.429,15,5,10,0.333,7,6,1,0.857,0,6,21,21
444,504,27,224,0.5,0.35,25,24,10,2.4,13,5,1,20,3,17,24,11,13,0.458,0.479,20,10,10,0.5,4,1,3,0.25,3,2,1,0.667,1,7,20,15
445,490,27,398,0.95,0.28,156,15,37,0.41,25,16,1,93,11,82,114,57,57,0.5,0.579,69,39,30,0.565,45,18,27,0.4,28,24,4,0.857,2,23,45,25
446,520,28,10,0.89,0.2,4,0,0,,0,0,0,2,0,2,3,1,2,0.333,0.5,0,0,0,,3,1,2,0.333,2,1,1,0.5,0,1,2,3
447,524,28,13,0.56,0.15,4,1,1,1,1,0,0,0,0,0,3,2,1,0.667,0.667,3,2,1,0.667,0,0,0,,0,0,0,,0,0,0,6
448,511,28,23,0.53,0.35,3,1,1,1,0,1,0,6,2,4,4,1,3,0.25,0.25,4,1,3,0.25,0,0,0,,2,1,1,0.5,0,1,4,7
449,510,28,492,0.76,0.18,139,37,25,1.48,10,15,0,38,5,33,111,40,71,0.36,0.423,59,26,33,0.441,52,14,38,0.269,54,45,9,0.833,2,39,23,25
450,514,28,779,1.17,0.21,429,59,88,0.67,32,48,15,102,29,73,350,162,188,0.463,0.496,260,139,121,0.535,90,23,67,0.256,102,82,20,0.804,12,78,65,25
451,513,28,381,0.61,0.25,103,32,19,1.68,8,7,1,42,8,34,102,37,65,0.363,0.441,50,21,29,0.42,52,16,36,0.308,20,13,7,0.65,3,18,41,25
452,509,28,539,0.41,0.16,106,50,38,1.32,9,19,0,37,9,28,127,36,91,0.284,0.354,69,18,51,0.261,58,18,40,0.31,22,16,6,0.727,2,22,33,25
453,526,28,832,1.45,0.26,537,24,67,0.36,21,35,2,200,55,145,418,193,225,0.462,0.494,339,166,173,0.49,79,27,52,0.342,160,124,36,0.775,12,123,64,25
454,523,28,15,0.24,0.27,2,0,0,,0,0,1,2,0,2,5,1,4,0.2,0.2,4,1,3,0.25,1,0,1,0,0,0,0,,0,0,1,8
455,518,28,78,0.68,0.36,11,4,3,1.33,2,2,2,14,4,10,11,3,8,0.273,0.273,10,3,7,0.3,1,0,1,0,6,5,1,0.833,0,3,6,19
456,517,28,602,1.16,0.36,233,57,49,1.16,29,31,9,96,28,68,153,71,82,0.464,0.546,89,46,43,0.517,64,25,39,0.391,86,66,20,0.767,4,67,58,24
457,512,28,299,0.9,0.61,57,14,11,1.27,16,5,9,94,31,63,50,24,26,0.48,0.48,48,24,24,0.5,2,0,2,0,15,9,6,0.6,0,10,31,21
458,508,28,7,0.54,0,3,0,0,,0,0,0,0,0,0,2,1,1,0.5,0.75,1,0,1,0,1,1,0,1,0,0,0,,0,0,1,5
459,525,28,226,0.94,0.54,54,8,10,0.8,7,3,12,67,22,45,47,22,25,0.468,0.468,47,22,25,0.468,0,0,0,,13,10,3,0.769,1,9,48,24
460,522,28,24,0.53,0.25,2,0,3,0,0,3,0,8,4,4,3,0,3,0,0,2,0,2,0,1,0,1,0,2,2,0,1,0,1,4,6
461,516,28,83,0.91,0.16,41,8,8,1,0,4,0,12,1,11,27,13,14,0.482,0.685,5,2,3,0.4,22,11,11,0.5,6,4,2,0.667,0,4,7,14
462,519,28,91,0.58,0.21,22,8,8,1,5,6,0,7,2,5,19,8,11,0.421,0.474,13,6,7,0.462,6,2,4,0.333,8,4,4,0.5,0,6,10,18
463,527,28,597,0.98,0.41,189,29,49,0.59,11,19,17,180,49,131,136,64,72,0.471,0.548,85,43,42,0.506,51,21,30,0.412,58,40,18,0.69,3,50,82,25
464,538,29,655,1.5,0.5,336,41,71,0.58,16,26,31,230,63,167,236,123,113,0.521,0.521,235,123,112,0.523,1,0,1,0,140,90,50,0.643,9,110,53,23
465,534,29,16,0.93,0.31,8,0,2,0,1,2,0,6,1,5,6,3,3,0.5,0.667,2,1,1,0.5,4,2,2,0.5,0,0,0,,0,0,2,11
466,539,29,67,0.14,0.1,4,2,3,0.67,1,1,0,6,1,5,6,2,4,0.333,0.333,6,2,4,0.333,0,0,0,,0,0,0,,0,1,10,14
467,547,29,19,0.52,0.37,1,3,3,1,0,2,1,4,1,3,1,0,1,0,0,1,0,1,0,0,0,0,,2,1,1,0.5,0,1,0,7
468,548,29,377,1.03,0.27,162,38,30,1.27,17,11,0,43,8,35,138,58,80,0.42,0.446,115,51,64,0.444,23,7,16,0.304,56,39,17,0.696,3,40,41,18
469,529,29,16,0.31,0.13,3,1,2,0.5,1,1,0,2,0,2,3,1,2,0.333,0.5,1,0,1,0,2,1,1,0.5,0,0,0,,0,0,2,7
470,537,29,101,0.42,0.2,28,3,6,0.5,4,2,2,9,5,4,36,12,24,0.333,0.375,22,9,13,0.409,14,3,11,0.214,5,1,4,0.2,1,6,17,7
471,543,29,439,0.94,0.37,165,33,26,1.27,38,16,3,54,11,43,164,61,103,0.372,0.415,112,47,65,0.42,52,14,38,0.269,36,29,7,0.806,4,35,55,21
472,544,29,207,1.07,0.19,98,11,23,0.48,5,8,2,35,14,21,70,32,38,0.457,0.529,48,22,26,0.458,22,10,12,0.454,37,24,13,0.649,2,23,27,15
473,541,29,72,0.49,0.15,17,2,5,0.4,1,2,2,10,1,9,11,6,5,0.546,0.727,3,2,1,0.667,8,4,4,0.5,2,1,1,0.5,0,1,8,14
474,540,29,61,0.51,0.25,14,7,4,1.75,1,4,1,5,0,5,15,5,10,0.333,0.433,2,2,0,1,13,3,10,0.231,2,1,1,0.5,0,1,6,14
475,549,29,17,0.83,0,10,0,1,0,0,0,0,1,1,0,9,4,5,0.444,0.5,8,3,5,0.375,1,1,0,1,1,1,0,1,1,1,4,6
476,536,29,54,0.36,-0.02,14,1,3,0.33,0,1,0,3,0,3,12,4,8,0.333,0.5,1,0,1,0,11,4,7,0.364,3,2,1,0.667,0,2,2,13
477,542,29,290,0.64,0.31,68,18,15,1.2,11,9,0,40,23,17,80,24,56,0.3,0.338,52,18,34,0.346,28,6,22,0.214,21,14,7,0.667,0,19,43,15
478,533,29,357,0.79,0.24,132,35,32,1.09,17,19,4,34,5,29,114,51,63,0.447,0.496,85,40,45,0.471,29,11,18,0.379,34,19,15,0.559,5,23,36,24
479,531,29,311,0.57,0.21,72,20,16,1.25,9,7,2,30,4,26,76,23,53,0.303,0.368,32,13,19,0.406,44,10,34,0.227,20,16,4,0.8,3,15,24,23
480,546,29,319,0.62,0.17,73,8,12,0.67,6,4,2,39,7,32,73,18,55,0.247,0.322,31,7,24,0.226,42,11,31,0.262,30,26,4,0.867,1,17,25,22
481,545,29,368,1.05,0.41,154,10,12,0.83,7,6,18,81,24,57,132,62,70,0.47,0.504,99,53,46,0.535,33,9,24,0.273,30,21,9,0.7,6,27,37,23
482,530,29,684,0.95,0.45,223,65,31,2.1,60,18,1,89,28,61,201,85,116,0.423,0.468,146,67,79,0.459,55,18,37,0.327,50,35,15,0.7,3,34,45,25
483,532,29,343,0.74,0.31,132,14,12,1.17,14,7,6,49,15,34,122,47,75,0.385,0.537,18,10,8,0.556,104,37,67,0.356,3,1,2,0.333,1,6,37,24
484,528,29,326,0.63,0.3,83,15,21,0.71,3,8,9,67,18,49,79,38,41,0.481,0.481,79,38,41,0.481,0,0,0,,12,7,5,0.583,2,14,36,24
485,565,30,39,0.5,0.33,6,1,1,1,2,0,0,6,3,3,6,3,3,0.5,0.5,6,3,3,0.5,0,0,0,,0,0,0,,0,1,8,10
486,566,30,230,0.86,0.4,57,12,12,1,5,5,2,53,26,27,43,22,21,0.512,0.512,42,22,20,0.524,1,0,1,0,20,13,7,0.65,0,14,43,24
487,555,30,434,0.78,0.15,204,46,45,1.02,15,22,0,25,8,17,194,75,119,0.387,0.477,96,40,56,0.417,98,35,63,0.357,21,19,2,0.905,0,21,26,22
488,550,30,138,0.72,0.17,34,8,16,0.5,4,3,3,20,5,15,21,11,10,0.524,0.524,19,11,8,0.579,2,0,2,0,18,12,6,0.667,1,20,16,22
489,561,30,180,1.09,0.27,66,22,15,1.47,5,3,2,19,2,17,42,21,21,0.5,0.536,29,18,11,0.621,13,3,10,0.231,24,21,3,0.875,2,15,15,7
490,557,30,293,1.18,0.47,139,12,10,1.2,22,4,2,64,21,43,124,55,69,0.444,0.484,96,45,51,0.469,28,10,18,0.357,26,19,7,0.731,4,19,36,13
491,552,30,25,0.73,-0.08,9,1,6,0.17,2,3,0,3,1,2,3,3,0,1,0,2,2,0,1,1,1,0,1,2,2,0,1,0,2,3,6
492,563,30,9,2.12,1,5,1,0,,1,0,1,2,1,1,3,2,1,0.667,0.667,2,2,0,1,1,0,1,0,1,1,0,1,1,2,0,5
493,564,30,193,1.03,0.37,80,9,18,0.5,4,9,3,56,19,37,67,30,37,0.448,0.5,49,23,26,0.469,18,7,11,0.389,19,13,6,0.684,2,12,18,7
494,567,30,8,1.31,0.25,6,1,0,,0,0,0,0,0,0,3,2,1,0.667,1,0,0,0,,3,2,1,0.667,0,0,0,,0,0,1,3
495,568,30,574,1.1,0.36,268,19,58,0.33,16,20,21,153,55,98,232,110,122,0.474,0.485,217,105,112,0.484,15,5,10,0.333,58,43,15,0.741,10,49,71,25
496,570,30,92,0.72,0.09,26,1,9,0.11,1,4,2,14,4,10,18,8,10,0.444,0.444,18,8,10,0.444,0,0,0,,15,10,5,0.667,1,6,7,7
497,569,30,163,0.84,0.25,57,2,8,0.25,1,3,2,35,12,23,53,22,31,0.415,0.415,53,22,31,0.415,0,0,0,,19,13,6,0.684,0,16,19,16
498,553,30,416,0.86,0.16,158,15,30,0.5,10,19,2,57,17,40,126,50,76,0.397,0.476,74,30,44,0.405,52,20,32,0.385,47,38,9,0.808,3,29,34,19
499,559,30,120,0.28,0.26,10,4,6,0.67,8,2,0,16,3,13,20,4,16,0.2,0.25,9,2,7,0.222,11,2,9,0.182,0,0,0,,0,1,14,22
500,572,30,14,1.64,0.5,6,2,2,1,1,3,0,4,1,3,5,1,4,0.2,0.2,3,1,2,0.333,2,0,2,0,7,4,3,0.571,1,4,3,6
501,554,30,795,1.31,0.3,494,74,64,1.16,36,33,3,123,19,104,419,182,237,0.434,0.489,277,136,141,0.491,142,46,96,0.324,110,84,26,0.764,19,99,63,25
502,556,30,515,0.49,0.34,70,52,31,1.68,23,22,2,70,12,58,79,29,50,0.367,0.411,48,22,26,0.458,31,7,24,0.226,12,5,7,0.417,1,13,58,25
503,571,30,22,0.08,0.18,2,3,6,0.5,0,3,3,4,0,4,7,1,6,0.143,0.143,6,1,5,0.167,1,0,1,0,0,0,0,,0,0,2,2
504,551,30,177,0.53,0.12,66,5,15,0.33,4,6,0,23,11,12,63,23,40,0.365,0.516,8,4,4,0.5,55,19,36,0.346,2,1,1,0.5,0,2,19,24
505,558,30,162,0.8,0.31,57,12,5,2.4,8,6,1,18,1,17,58,20,38,0.345,0.414,29,12,17,0.414,29,8,21,0.276,15,9,6,0.6,0,11,14,21
506,560,30,25,0.44,0.08,7,1,3,0.33,0,1,0,4,2,2,7,2,5,0.286,0.429,2,0,2,0,5,2,3,0.4,2,1,1,0.5,0,1,2,7
507,577,31,456,0.69,0.15,155,24,23,1.04,8,12,1,42,5,37,141,49,92,0.348,0.447,61,21,40,0.344,80,28,52,0.35,33,29,4,0.879,0,26,34,28
508,589,31,404,1.1,0.18,211,5,25,0.2,7,11,3,69,23,46,163,84,79,0.515,0.524,156,81,75,0.519,7,3,4,0.429,49,40,9,0.816,8,40,39,28
509,575,31,24,0.18,0.25,0,1,0,,2,0,0,0,0,0,2,0,2,0,0,2,0,2,0,0,0,0,,0,0,0,,0,0,9,14
510,581,31,75,0.29,-0.05,22,3,6,0.5,1,4,0,0,0,0,20,7,13,0.35,0.525,5,0,5,0,15,7,8,0.467,2,1,1,0.5,0,2,4,9
511,583,31,677,1.15,0.35,292,35,40,0.88,10,14,7,169,44,125,209,114,95,0.546,0.553,203,111,92,0.547,6,3,3,0.5,80,61,19,0.762,8,64,60,27
512,580,31,404,0.41,0.25,40,29,23,1.26,13,8,0,52,12,40,43,13,30,0.302,0.36,18,8,10,0.444,25,5,20,0.2,13,9,4,0.692,0,14,41,28
513,584,31,14,0.33,-0.14,6,0,1,0,0,1,0,0,0,0,6,2,4,0.333,0.417,3,1,2,0.333,3,1,2,0.333,4,1,3,0.25,0,2,0,8
514,578,31,768,1.05,0.25,330,64,46,1.39,13,23,4,108,14,94,261,99,162,0.379,0.473,126,50,76,0.397,135,49,86,0.363,109,83,26,0.761,12,78,47,28
515,585,31,92,0.73,0.29,31,4,1,4,0,1,0,19,2,17,30,13,17,0.433,0.483,15,10,5,0.667,15,3,12,0.2,2,2,0,1,0,3,8,19
516,573,31,631,0.55,0.24,113,51,35,1.46,14,16,1,72,18,54,100,38,62,0.38,0.44,48,26,22,0.542,52,12,40,0.231,35,25,10,0.714,2,30,82,28
517,579,31,74,0.27,0.24,5,1,1,1,1,0,0,13,3,10,11,2,9,0.182,0.182,10,2,8,0.2,1,0,1,0,2,1,1,0.5,0,2,8,19
518,592,31,39,0.27,0.1,5,0,4,0,1,1,0,10,0,10,5,2,3,0.4,0.4,5,2,3,0.4,0,0,0,,3,1,2,0.333,0,3,10,11
519,586,31,54,1.47,0.28,23,4,1,4,1,0,0,5,2,3,17,5,12,0.294,0.294,17,5,12,0.294,0,0,0,,14,13,1,0.929,0,9,5,13
520,574,31,893,0.65,0.33,176,111,34,3.26,28,17,2,74,9,65,165,59,106,0.358,0.418,93,39,54,0.419,72,20,52,0.278,60,38,22,0.633,2,58,55,28
521,476,26,24,1.69,0.13,23,1,5,0.2,1,0,1,6,1,5,15,10,5,0.667,0.7,12,9,3,0.75,3,1,2,0.333,2,2,0,1,0,0,4,1
521,587,31,646,1.42,0.43,424,39,80,0.49,27,32,27,198,55,143,369,180,189,0.488,0.499,333,172,161,0.516,36,8,28,0.222,85,56,29,0.659,16,71,70,26
522,576,31,228,0.79,0.35,77,24,20,1.2,4,9,9,35,10,25,74,33,41,0.446,0.466,66,30,36,0.454,8,3,5,0.375,15,8,7,0.533,1,18,34,13
523,588,31,4,1.83,1.25,2,1,0,,1,0,0,1,0,1,1,1,0,1,1,1,1,0,1,0,0,0,,1,0,1,0,0,1,0,7
524,607,32,24,-0.02,0,2,2,3,0.67,0,1,0,2,0,2,4,1,3,0.25,0.25,4,1,3,0.25,0,0,0,,1,0,1,0,0,1,8,10
525,606,32,261,0.74,0.33,92,7,9,0.78,10,3,2,51,16,35,79,38,41,0.481,0.576,38,23,15,0.605,41,15,26,0.366,6,1,5,0.167,1,9,26,20
526,610,32,357,0.46,0.19,95,14,10,1.4,9,7,2,32,6,26,95,33,62,0.347,0.495,11,5,6,0.454,84,28,56,0.333,4,1,3,0.25,0,5,13,25
527,613,32,442,0.65,0.2,130,41,46,0.89,9,25,0,64,16,48,127,42,85,0.331,0.413,66,21,45,0.318,61,21,40,0.344,34,25,9,0.735,0,35,26,16
528,597,32,614,0.97,0.33,249,64,36,1.78,38,24,4,51,13,38,206,91,115,0.442,0.519,103,59,44,0.573,103,32,71,0.311,45,35,10,0.778,4,34,26,26
529,605,32,8,-0.38,0.13,0,0,1,0,0,0,0,2,1,1,5,0,5,0,0,0,0,0,,5,0,5,0,0,0,0,,0,0,1,3
530,604,32,12,0.03,-0.17,2,0,2,0,0,2,0,1,1,0,2,1,1,0.5,0.5,1,1,0,1,1,0,1,0,0,0,0,,0,0,1,6
531,596,32,68,0.32,0.29,2,9,8,1.12,2,8,0,11,3,8,3,1,2,0.333,0.333,1,1,0,1,2,0,2,0,0,0,0,,0,0,4,12
532,603,32,544,1.32,0.53,246,36,30,1.2,17,13,12,162,56,106,192,94,98,0.49,0.518,165,83,82,0.503,27,11,16,0.407,58,47,11,0.81,6,43,48,26
533,599,32,180,0.45,0.34,8,11,10,1.1,9,3,0,32,10,22,6,2,4,0.333,0.333,6,2,4,0.333,0,0,0,,7,4,3,0.571,1,13,22,24
534,595,32,213,0.46,0.26,35,22,11,2,5,10,0,20,3,17,39,11,28,0.282,0.385,8,3,5,0.375,31,8,23,0.258,9,5,4,0.556,0,8,26,22
535,608,32,52,0.33,-0.02,14,1,8,0.12,3,4,1,4,1,3,12,6,6,0.5,0.542,8,5,3,0.625,4,1,3,0.25,3,1,2,0.333,1,4,5,9
536,615,32,531,1.05,0.35,231,25,28,0.89,14,16,5,116,36,80,197,91,106,0.462,0.49,169,80,89,0.473,28,11,17,0.393,52,38,14,0.731,7,34,67,27
537,611,32,764,1.24,0.29,454,44,59,0.75,17,36,3,158,56,102,383,183,200,0.478,0.501,346,165,181,0.477,37,18,19,0.486,91,70,21,0.769,9,72,75,27
538,594,32,820,1.14,0.5,300,105,70,1.5,33,49,42,163,28,135,237,112,125,0.473,0.481,223,108,115,0.484,14,4,10,0.286,135,72,63,0.533,23,109,59,27
539,598,32,298,1.01,0.27,136,22,25,0.88,13,6,0,50,10,40,120,50,70,0.417,0.458,87,40,47,0.46,33,10,23,0.303,39,26,13,0.667,7,32,29,13
